30 100
CAATTTCGAACTAAGTAGTAAACAATCCCG|GGTCCTGAACTGCGCGATAATAACCTGTGC
TGCAGGAGTCAACCCCAAGAGAGTGGGGTT|CCCTGAATTGTTCAGAAACGTGTCACCTCG
GTCAACCCCAAGAGAGTGGGGTTTGCGTAA|TTGTTCAGAAACGTGTCACCTCGTAGCTAC
TATGCCGCTCTAACTAATTTATACTGGTCA|TGCAGGAGTCAACCCCAATTTCGAACTAAG
TAACTGCACGAAAACCGTGATAATAACCTG|GTGCAGGAGTCAACCCCAAGCCAACCACGC
GGAGTCAACCCCAACAACCCCAATACGACG|AATAACCTGTGCAGGAGTCAACCCCAAGAC
TGCCGCTCTAACTAATTTATACTGGTCACA|CAGGAGTCAACCCCAATTTCGAACTAAGTA
CCCCAACAACCCCAATACGACGGCTATGCG|GTGCAGGAGTCAACCCCAAGACTTCACGCG
CTCGTTACCCCATGCCGAATGCCTATTGGC|TTTGATAATAACCTGTGCAGGAGTCAACCC
AAGACTTCACGCGCGATAATAACCTGTGCA|GTGTCTGCGACGCTACAGTGAGCCTACATC
TAATAACCTGTGCAGGAGTCAACCCCAATT|AGTGAGCCTACATCGGAAAATCGTTGGTCC
CCGAGTAGCTCTATCTTAGTTTTTTGATAA|CAAGACGCATGTACCTAATCATACAGCAGT
CCGAATGCCTATTGGCGCCTGGTCCCCAAC|GTGCAGGAGTCAACCCCAACGGATTGGGTT
GAGATAATAACCGATAATAACCTGTGCAGG|ACCTGTGCAGGAGTCAACCCCAACAACCCC
GGTTTGCGTAACCCCACGGCCAGCTGTCTT|CTCGTAGCTACCGAGTAGCTCTATCTTAGT
GGAGTCAACCCCAAACGCATCTTGTGTCCG|GTACCTCCAACGGCTTTTCTGTGCCCGAAA
CTACATCGGAAAATCGTTGGTCCTGAACTG|GGGGAGGTGTCCGGCAACTCCGCACGAGCC
TGCAGGAGTCAACCCCAATGTGCAGGAGTC|AACCCCAATACGACGGCTATGCGGAGGTAC
ACCTGTGCAGGAGTGATAATAACCTGTGCA|TTGGTGGTGACCTGGCCGTAAGTATCCGAT
TAAGTATCCGATAATAACCTGTGCAGGAGT|TCAACCCCAATAAAAAATCTAGGCAACTAG
CAGGAGTCAACCCCAATAATAACCTGTGCA|GGAGGTACTAAAGGTATGCCGCTCTAACTA
TGTACATCGAGATAATAACCTGTGCAGGAG|ATGATAACGGCGCAATGTCGCCTCTTGTAC
AATAACCTGTGCAGGAGTCAACCCCAATGT|AACCCCAACAACCCCAATACGACGGCTATG
GATTGGGTTTCTGTACATCGAGATAATAAC|CGGGGCACCCGATGATAACGGCGCAATGTC
GCAGGAGTCAACCCCAAGCCAACCACGCGG|CTAATTTATACTGGTCACACGGTGATGAGC
ACTCCGCACGAGCCGTATCAGACTTGGCAC|TCGTAATACCGCTACAACTTGCTGAGTGGC
CCTTGGTGGTGACCTGGCCGTAAGTATCCG|GATAATAACCTGTGCAGGAGTCAACCCCAA
CCCACGGCCAGCTGTCTTACCGGACTAGTT|GAGTAGCTCTATCTTAGTTTTTTGATAATA
CAGGAGTGATAATAACCTGTGCAGGAGTCA|TGACCTGGCCGTAAGTATCCGATAATAACC
AGTAGTAAACAATCCCGACGATAATAACCT|GCGATAATAACCTGTGCAGGAGTCAACCCC
AGTGTCTGCGACGCTACAGTGAGCCTACAT|ACTAGTTTCGATGCCATCACATTTGGGGAG
CATATATACAGCCATTTCGGAAGACAGGCA|AACCTGTGCAGGAGTCAACCCCAAACGCAT
TCGCTATCCCAGAATCCGCATATATACAGC|TCTGTACATCGAGATAATAACCTGTGCAGG
CCGGCAACTCCGCACGAGCCGTATCAGACT|TTCACGTCGTAATACCGCTACAACTTGCTG
GTGAGCCTACATCGGAAAATCGTTGGTCCT|ACATTTGGGGAGGTGTCCGGCAACTCCGCA
ACGAAAACCGTGATAATAACCTGTGCAGGA|AGTCAACCCCAAGCCAACCACGCGGATAAT
AGAAGGGAACGGTTTATGAGACGATGCTTG|AAAACCGTGATAATAACCTGTGCAGGAGTC
GCTGTCGCATTTTGATAATAACCTGTGCAG|GGAATTCAAATGCGCAGAAGGGAACGGTTT
CCATGCCGAATGCCTATTGGCGCCTGGTCC|AACCTGTGCAGGAGTCAACCCCAACGGATT
TTTTGATAATAACCTGTGCAGGAGTCAACC|TACAGCAGTGACCGAAGCGGTTTCTGCCTC
CACACGGTGATGAGCCGACCCTTGGTGGTG|AGTAGTAAACAATCCCGACGATAATAACCT
GCCGTAAGTATCCGATAATAACCTGTGCAG|GGAGTCAACCCCAATAAAAAATCTAGGCAA
AGGAGTCAACCCCAATGTGCAGGAGTCAAC|CCCAATACGACGGCTATGCGGAGGTACTAA
AACCTGTGCAGGAGTCAACCCCAACAACCC|AGTATCCGATAATAACCTGTGCAGGAGTCA
AAAATCTAGGCAACTAGATACCTAGTGTCT|CCCACGGCCAGCTGTCTTACCGGACTAGTT
CCCAACCTATTCACGTCGTAATACCGCTAC|CAACGAGCGGACACAGAAAAAGATCTGACG
AGGAGTCAACCCCAAGAGAGTGGGGTTTGC|TGAATTGTTCAGAAACGTGTCACCTCGTAG
CCTGTGCAGGAGTCAACCCCAATAAAAAAT|CCCAAGAGAGTGGGGTTTGCGTAACCCCAC
ATTTACGCCGGAGAAGAAAGTCGAACGAAG|TCTTGTGTCCGTTTGAGATAATTTCGGGCG
CGGCTATGCGGAGGTACTAAAGGTATGCCG|ACTTCACGCGCGATAATAACCTGTGCAGGA
GTGATAATAACCTGTGCAGGAGTCAACCCC|CAAGCCAACCACGCGGATAATAACCTGTGC
CAACCCCAATACGACGGCTATGCGGAGGTA|GAGTCAACCCCAAGACTTCACGCGCGATAA
TGTGCAGGAGTCAACCCCAAACGCATCTTG|CCTCTTGTACCTCCAACGGCTTTTCTGTGC
AACCCCAATTTCGAACTAAGTAGTAAACAA|TCGTTGGTCCTGAACTGCGCGATAATAACC
ATAATAACCTGTGCAGGAGTCAACCCCAAT|TCAACCCCAACAACCCCAATACGACGGCTA
TGGTCGTTCGATGAAGTGCGCGGCGGCGAT|CGAATGCCTATTGGCGCCTGGTCCCCAACT
GCGCGGCGGCGATAATAACCTGTGCAGGAG|CTGGTCCCCAACTCGCTATCCCAGAATCCG
TGGTGGTGACCTGGCCGTAAGTATCCGATA|AATAACCTGTGCAGGAGTCAACCCCAATAA
AAGTGCGCGGCGGCGATAATAACCTGTGCA|GCGCCTGGTCCCCAACTCGCTATCCCAGAA
AATAAAAGAGATAATAACCGATAATAACCT|GATAATAACCTGTGCAGGAGTCAACCCCAA
CTGTGCAGGAGTCAACCCCAAGCCAACCAC|CTAACTAATTTATACTGGTCACACGGTGAT
ATCCGCATATATACAGCCATTTCGGAAGAC|ATAATAACCTGTGCAGGAGTCAACCCCAAA
CCCAAGAGAGTGGGGTTTGCGTAACCCCAC|AGAAACGTGTCACCTCGTAGCTACCGAGTA
ATTTCGGGCGGAATTCAAATGCGCAGAAGG|GTCCCGAATCATAGTAACTGCACGAAAACC
ATAATAACCTGTGCAGGAGTCAACCCCAAT|CAGTGAGCCTACATCGGAAAATCGTTGGTC
ACCGGTGATGGTCCCGAATCATAGTAACTG|AGGAGTCAACCCCAATAATAACCTGTGCAG
CGGCGGCGATAATAACCTGTGCAGGAGTGA|GTCCCCAACTCGCTATCCCAGAATCCGCAT
CCCAATAATAACCTGTGCAGGAGTCAACCC|AGGTATGCCGCTCTAACTAATTTATACTGG
CCTCCAACGGCTTTTCTGTGCCCGAAACCG|CTGTGCAGGAGTCAACCCCAATGTGCAGGA
CCCCAAAGTGAATAAAAGAGATAATAACCG|GTGCAGGAGTGATAATAACCTGTGCAGGAG
TTTATACTGGTCACACGGTGATGAGCCGAC|ATTTCGAACTAAGTAGTAAACAATCCCGAC
GGGAACGGTTTATGAGACGATGCTTGCGGG|CCGTGATAATAACCTGTGCAGGAGTCAACC
ACACGGTGATGAGCCGACCCTTGGTGGTGA|GTAGTAAACAATCCCGACGATAATAACCTG
AGAGATAATAACCGATAATAACCTGTGCAG|AACCTGTGCAGGAGTCAACCCCAACAACCC
TATCCGATAATAACCTGTGCAGGAGTCAAC|CCCCAATAAAAAATCTAGGCAACTAGATAC
GCGGCGATAATAACCTGTGCAGGAGTGATA|CCCCAACTCGCTATCCCAGAATCCGCATAT
AGGAGTCAACCCCAACAACCCCAACTGTTA|TCGGAAGACAGGCATTTACGCCGGAGAAGA
GAAGTGCGCGGCGGCGATAATAACCTGTGC|GGCGCCTGGTCCCCAACTCGCTATCCCAGA
AAAGAGATAATAACCGATAATAACCTGTGC|ATAACCTGTGCAGGAGTCAACCCCAACAAC
CTGTGCAGGAGTGATAATAACCTGTGCAGG|GGTGGTGACCTGGCCGTAAGTATCCGATAA
GGAAGACAGGCATTTACGCCGGAGAAGAAA|CCCCAAACGCATCTTGTGTCCGTTTGAGAT
TCAACCCCAATAAAAAATCTAGGCAACTAG|GGGTTTGCGTAACCCCACGGCCAGCTGTCT
AACCCCAATGTGCAGGAGTCAACCCCAATA|CGACGGCTATGCGGAGGTACTAAAGGTATG
GCATTTACGCCGGAGAAGAAAGTCGAACGA|CATCTTGTGTCCGTTTGAGATAATTTCGGG
AATAACCTGTGCAGGAGTCAACCCCAAGCC|GCCGCTCTAACTAATTTATACTGGTCACAC
CTAGTGTCTGCGACGCTACAGTGAGCCTAC|GGACTAGTTTCGATGCCATCACATTTGGGG
GCAGGAGTCAACCCCAATAAAAAATCTAGG|GAGAGTGGGGTTTGCGTAACCCCACGGCCA
TGCTTGCGGGGCACCCGATGATAACGGCGC|GGAGTCAACCCCAAAGTGAATAAAAGAGAT
TCTATCTTAGTTTTTTGATAATAACCTGTG|TGTACCTAATCATACAGCAGTGACCGAAGC
AACCTGTGCAGGAGTCAACCCCAAACGCAT|GTCGCCTCTTGTACCTCCAACGGCTTTTCT
CTACCGAGTAGCTCTATCTTAGTTTTTTGA|TGGCAAGACGCATGTACCTAATCATACAGC
TCACGCGCGATAATAACCTGTGCAGGAGTC|GCGACGCTACAGTGAGCCTACATCGGAAAA
CTCCGCACGAGCCGTATCAGACTTGGCACC|CGTAATACCGCTACAACTTGCTGAGTGGCT
AGGAGTCAACCCCAACCTATTCACGTCGTA|GTTTCTGCCTCAACGAGCGGACACAGAAAA
ACCTGTGCAGGAGTCAACCCCAAAGTGAAT|CACGCGGATAATAACCTGTGCAGGAGTGAT
AATAACCTGTGCAGGAGTCAACCCCAAGAG|GACTTGGCACCCTGAATTGTTCAGAAACGT
CTCGTAGCTACCGAGTAGCTCTATCTTAGT|TTAGTACTGGCAAGACGCATGTACCTAATC
GTCAACCCCAATGTGCAGGAGTCAACCCCA|ATACGACGGCTATGCGGAGGTACTAAAGGT
CAGGAGTCAACCCCAAGCCAACCACGCGGA|TAATTTATACTGGTCACACGGTGATGAGCC
GATGCTTGCGGGGCACCCGATGATAACGGC|CAGGAGTCAACCCCAAAGTGAATAAAAGAG
CAATGTCGCCTCTTGTACCTCCAACGGCTT|TAATAACCGATAATAACCTGTGCAGGAGTC
GATAATTTCGGGCGGAATTCAAATGCGCAG|GATGGTCCCGAATCATAGTAACTGCACGAA
GAGTCAACCCCAATAATAACCTGTGCAGGA|GGTACTAAAGGTATGCCGCTCTAACTAATT
GAAGCTGTCGCATTTTGATAATAACCTGTG|GGCGGAATTCAAATGCGCAGAAGGGAACGG
GTCAACCCCAACAACCCCAACTGTTATTAC|AAGACAGGCATTTACGCCGGAGAAGAAAGT
TGGGGAGGTGTCCGGCAACTCCGCACGAGC|ACCCCAACCTATTCACGTCGTAATACCGCT
GAATGCCTATTGGCGCCTGGTCCCCAACTC|GCAGGAGTCAACCCCAACGGATTGGGTTTC
CCCCAATAATAACCTGTGCAGGAGTCAACC|AAGGTATGCCGCTCTAACTAATTTATACTG
ATGTCGCCTCTTGTACCTCCAACGGCTTTT|ATAACCGATAATAACCTGTGCAGGAGTCAA
AGGAGTCAACCCCAATAAAAAATCTAGGCA|GAGTGGGGTTTGCGTAACCCCACGGCCAGC
TGGTCCTGAACTGCGCGATAATAACCTGTG|CTCCGCACGAGCCGTATCAGACTTGGCACC
AACCCCAAGAGAGTGGGGTTTGCGTAACCC|TTCAGAAACGTGTCACCTCGTAGCTACCGA
GAACGGTTTATGAGACGATGCTTGCGGGGC|GTGATAATAACCTGTGCAGGAGTCAACCCC
AACTGCGCGATAATAACCTGTGCAGGAGTC|GAGCCGTATCAGACTTGGCACCCTGAATTG
ATAACCTGTGCAGGAGTGATAATAACCTGT|CCCTTGGTGGTGACCTGGCCGTAAGTATCC
CGATGATAACGGCGCAATGTCGCCTCTTGT|GTGAATAAAAGAGATAATAACCGATAATAA
GGTGATGAGCCGACCCTTGGTGGTGACCTG|TAAACAATCCCGACGATAATAACCTGTGCA
TGATAATAACCTGTGCAGGAGTCAACCCCA|CGCAGAAGGGAACGGTTTATGAGACGATGC
CGGAGAAGAAAGTCGAACGAAGCTGTCGCA|CCGTTTGAGATAATTTCGGGCGGAATTCAA
TGAGATAATTTCGGGCGGAATTCAAATGCG|GGTGATGGTCCCGAATCATAGTAACTGCAC
ATACAGAAGCTCGTTACCCCATGCCGAATG|CTGTCGCATTTTGATAATAACCTGTGCAGG
TCCGCACGAGCCGTATCAGACTTGGCACCC|GTAATACCGCTACAACTTGCTGAGTGGCTT
CTATGCGGAGGTACTAAAGGTATGCCGCTC|TCACGCGCGATAATAACCTGTGCAGGAGTC
ACGGATTGGGTTTCTGTACATCGAGATAAT|TTGCGGGGCACCCGATGATAACGGCGCAAT
GAATCCGCATATATACAGCCATTTCGGAAG|AGATAATAACCTGTGCAGGAGTCAACCCCA
AAGACAGGCATTTACGCCGGAGAAGAAAGT|CCAAACGCATCTTGTGTCCGTTTGAGATAA
GCGGCGGCGATAATAACCTGTGCAGGAGTG|GGTCCCCAACTCGCTATCCCAGAATCCGCA
CTTGTACCTCCAACGGCTTTTCTGTGCCCG|AATAACCTGTGCAGGAGTCAACCCCAATGT
CTGTGCAGGAGTCAACCCCAATGTGCAGGA|AACAACCCCAATACGACGGCTATGCGGAGG
CTGTGCAGGAGTCAACCCCAACCTATTCAC|GAAGCGGTTTCTGCCTCAACGAGCGGACAC
TTTGGGGAGGTGTCCGGCAACTCCGCACGA|CAACCCCAACCTATTCACGTCGTAATACCG
GAGCCTACATCGGAAAATCGTTGGTCCTGA|ATTTGGGGAGGTGTCCGGCAACTCCGCACG
AGGAGTGATAATAACCTGTGCAGGAGTCAA|GACCTGGCCGTAAGTATCCGATAATAACCT
TATTGGCGCCTGGTCCCCAACTCGCTATCC|TCAACCCCAACGGATTGGGTTTCTGTACAT
CCAATGTGCAGGAGTCAACCCCAATAATAA|GGCTATGCGGAGGTACTAAAGGTATGCCGC
GGAACGGTTTATGAGACGATGCTTGCGGGG|CGTGATAATAACCTGTGCAGGAGTCAACCC
TAATTTCGGGCGGAATTCAAATGCGCAGAA|TGGTCCCGAATCATAGTAACTGCACGAAAA
ATATACAGCCATTTCGGAAGACAGGCATTT|CTGTGCAGGAGTCAACCCCAAACGCATCTT
GGAGTCAACCCCAATAATAACCTGTGCAGG|AGGTACTAAAGGTATGCCGCTCTAACTAAT
TCCCGACGATAATAACCTGTGCAGGAGTCA|TGTGCAGGAGTCAACCCCAAGAGAGTGGGG
CAATAATAACCTGTGCAGGAGTCAACCCCA|GTATGCCGCTCTAACTAATTTATACTGGTC
ATCATAGTAACTGCACGAAAACCGTGATAA|ATAACCTGTGCAGGAGTCAACCCCAAGCCA
AAGAGAGTGGGGTTTGCGTAACCCCACGGC|AACGTGTCACCTCGTAGCTACCGAGTAGCT
GGAGTCAACCCCAATGTGCAGGAGTCAACC|CCAATACGACGGCTATGCGGAGGTACTAAA
CAGAAACGTGTCACCTCGTAGCTACCGAGT|TTCTTCTATGGTACTTAGTACTGGCAAGAC
GGCGATAATAACCTGTGCAGGAGTGATAAT|CCAACTCGCTATCCCAGAATCCGCATATAT
GTCAACCCCAAGCCAACCACGCGGATAATA|TATACTGGTCACACGGTGATGAGCCGACCC
ACCGTGATAATAACCTGTGCAGGAGTCAAC|CCCCAAGCCAACCACGCGGATAATAACCTG
ACCCCAAAGTGAATAAAAGAGATAATAACC|TGTGCAGGAGTGATAATAACCTGTGCAGGA
ATAATAACCTGTGCAGGAGTCAACCCCAAG|TAAAAAATCTAGGCAACTAGATACCTAGTG
CGAGTAGCTCTATCTTAGTTTTTTGATAAT|AAGACGCATGTACCTAATCATACAGCAGTG
TGTGCAGGAGTCAACCCCAATGTGCAGGAG|ACAACCCCAATACGACGGCTATGCGGAGGT
TCAACCCCAACCTATTCACGTCGTAATACC|TGCCTCAACGAGCGGACACAGAAAAAGATC
AATAACCTGTGCAGGAGTCAACCCCAACAA|TATACAGCCATTTCGGAAGACAGGCATTTA
TGAATTGTTCAGAAACGTGTCACCTCGTAG|TCCACCGTGTTCTTCTATGGTACTTAGTAC
CCTGTGCAGGAGTCAACCCCAAGACTTCAC|TCTAGGCAACTAGATACCTAGTGTCTGCGA
CGACGGCTATGCGGAGGTACTAAAGGTATG|AAGACTTCACGCGCGATAATAACCTGTGCA
CGCATCTTGTGTCCGTTTGAGATAATTTCG|TTTCTGTGCCCGAAACCGGTGATGGTCCCG
GGAGTCAACCCCAACCTATTCACGTCGTAA|TTTCTGCCTCAACGAGCGGACACAGAAAAA
ACCCCAACGGATTGGGTTTCTGTACATCGA|CGATGCTTGCGGGGCACCCGATGATAACGG
AGGAGTCAACCCCAACAACCCCAATACGAC|TAATAACCTGTGCAGGAGTCAACCCCAAGA
AGATGGTCGTTCGATGAAGTGCGCGGCGGC|TGCCGAATGCCTATTGGCGCCTGGTCCCCA
TAGATACCTAGTGTCTGCGACGCTACAGTG|TCTTACCGGACTAGTTTCGATGCCATCACA
TTCACGTCGTAATACCGCTACAACTTGCTG|GACACAGAAAAAGATCTGACGTTGGCGCTT
GATAACGGCGCAATGTCGCCTCTTGTACCT|ATAAAAGAGATAATAACCGATAATAACCTG
CTGTGCCCGAAACCGGTGATGGTCCCGAAT|CCCCAATGTGCAGGAGTCAACCCCAATAAT
CTGCGCGATAATAACCTGTGCAGGAGTCAA|GCCGTATCAGACTTGGCACCCTGAATTGTT
TCCCGAATCATAGTAACTGCACGAAAACCG|CCAATAATAACCTGTGCAGGAGTCAACCCC
TGATAATAACCTGTGCAGGAGTCAACCCCA|GGCCGTAAGTATCCGATAATAACCTGTGCA
ACATTTGGGGAGGTGTCCGGCAACTCCGCA|AGTCAACCCCAACCTATTCACGTCGTAATA
CCCAAGCCAACCACGCGGATAATAACCTGT|GGTCACACGGTGATGAGCCGACCCTTGGTG
TTTTTTGATAATAACCTGTGCAGGAGTCAA|CATACAGCAGTGACCGAAGCGGTTTCTGCC
AAGTAGTAAACAATCCCGACGATAATAACC|CGCGATAATAACCTGTGCAGGAGTCAACCC
CCTGTGCAGGAGTGATAATAACCTGTGCAG|TGGTGGTGACCTGGCCGTAAGTATCCGATA
CGCCTCTTGTACCTCCAACGGCTTTTCTGT|CCGATAATAACCTGTGCAGGAGTCAACCCC
GTATCAGACTTGGCACCCTGAATTGTTCAG|CAACTTGCTGAGTGGCTTTCCACCGTGTTC
TGTGCAGGAGTGATAATAACCTGTGCAGGA|GTGGTGACCTGGCCGTAAGTATCCGATAAT
AAGTCGAACGAAGCTGTCGCATTTTGATAA|ATAATTTCGGGCGGAATTCAAATGCGCAGA
CACCCGATGATAACGGCGCAATGTCGCCTC|CAAAGTGAATAAAAGAGATAATAACCGATA
CCTGGCCGTAAGTATCCGATAATAACCTGT|TGCAGGAGTCAACCCCAATAAAAAATCTAG
CTCGCTATCCCAGAATCCGCATATATACAG|TTCTGTACATCGAGATAATAACCTGTGCAG
GCTTTTCTGTGCCCGAAACCGGTGATGGTC|AGTCAACCCCAATGTGCAGGAGTCAACCCC
AATCCCGACGATAATAACCTGTGCAGGAGT|CCTGTGCAGGAGTCAACCCCAAGAGAGTGG
TGGTCACACGGTGATGAGCCGACCCTTGGT|ACTAAGTAGTAAACAATCCCGACGATAATA
ATTTCGGAAGACAGGCATTTACGCCGGAGA|GTCAACCCCAAACGCATCTTGTGTCCGTTT
AGAAGCTCGTTACCCCATGCCGAATGCCTA|CGCATTTTGATAATAACCTGTGCAGGAGTC
AAAGTGAATAAAAGAGATAATAACCGATAA|AGGAGTGATAATAACCTGTGCAGGAGTCAA
GCATCTTGTGTCCGTTTGAGATAATTTCGG|TTCTGTGCCCGAAACCGGTGATGGTCCCGA
TTGCGGGGCACCCGATGATAACGGCGCAAT|GTCAACCCCAAAGTGAATAAAAGAGATAAT
GTGCAGGAGTCAACCCCAATGTGCAGGAGT|CAACCCCAATACGACGGCTATGCGGAGGTA
GCGGATAATAACCTGTGCAGGAGTGATAAT|GAGCCGACCCTTGGTGGTGACCTGGCCGTA
TTTCTGTACATCGAGATAATAACCTGTGCA|CCCGATGATAACGGCGCAATGTCGCCTCTT
TGTCACCTCGTAGCTACCGAGTAGCTCTAT|TGGTACTTAGTACTGGCAAGACGCATGTAC
GGTTTATGAGACGATGCTTGCGGGGCACCC|TAATAACCTGTGCAGGAGTCAACCCCAAAG
GCAGGAGTCAACCCCAATAATAACCTGTGC|CGGAGGTACTAAAGGTATGCCGCTCTAACT
CGAACGAAGCTGTCGCATTTTGATAATAAC|TTTCGGGCGGAATTCAAATGCGCAGAAGGG
CTTGGCACCCTGAATTGTTCAGAAACGTGT|TGAGTGGCTTTCCACCGTGTTCTTCTATGG
ACCGATAATAACCTGTGCAGGAGTCAACCC|GGAGTCAACCCCAACAACCCCAATACGACG
AATTTCGGGCGGAATTCAAATGCGCAGAAG|GGTCCCGAATCATAGTAACTGCACGAAAAC
CACGAAAACCGTGATAATAACCTGTGCAGG|GAGTCAACCCCAAGCCAACCACGCGGATAA
GATAATAACCTGTGCAGGAGTCAACCCCAA|CGCAATGTCGCCTCTTGTACCTCCAACGGC
CAACCCCAATAATAACCTGTGCAGGAGTCA|CTAAAGGTATGCCGCTCTAACTAATTTATA
ATAATAACCTGTGCAGGAGTCAACCCCAAC|TATATACAGCCATTTCGGAAGACAGGCATT
AGGAGTCAACCCCAATTTCGAACTAAGTAG|CGGAAAATCGTTGGTCCTGAACTGCGCGAT
TTTGATAATAACCTGTGCAGGAGTCAACCC|TGCGCAGAAGGGAACGGTTTATGAGACGAT
ATACTGGTCACACGGTGATGAGCCGACCCT|TCGAACTAAGTAGTAAACAATCCCGACGAT
CGGCTTTTCTGTGCCCGAAACCGGTGATGG|GGAGTCAACCCCAATGTGCAGGAGTCAACC
CTAGGCAACTAGATACCTAGTGTCTGCGAC|GGCCAGCTGTCTTACCGGACTAGTTTCGAT
GTCAACCCCAAAGTGAATAAAAGAGATAAT|AACCTGTGCAGGAGTGATAATAACCTGTGC
AATGCCTATTGGCGCCTGGTCCCCAACTCG|CAGGAGTCAACCCCAACGGATTGGGTTTCT
GCAGAAGGGAACGGTTTATGAGACGATGCT|CGAAAACCGTGATAATAACCTGTGCAGGAG
GTTTTTTGATAATAACCTGTGCAGGAGTCA|TCATACAGCAGTGACCGAAGCGGTTTCTGC
CGAATGCCTATTGGCGCCTGGTCCCCAACT|TGCAGGAGTCAACCCCAACGGATTGGGTTT
AACCGGTGATGGTCCCGAATCATAGTAACT|CAGGAGTCAACCCCAATAATAACCTGTGCA
CATTTACGCCGGAGAAGAAAGTCGAACGAA|ATCTTGTGTCCGTTTGAGATAATTTCGGGC
CCCGATGATAACGGCGCAATGTCGCCTCTT|AAGTGAATAAAAGAGATAATAACCGATAAT
AACGGATTGGGTTTCTGTACATCGAGATAA|CTTGCGGGGCACCCGATGATAACGGCGCAA
TGTGCCCGAAACCGGTGATGGTCCCGAATC|CCCAATGTGCAGGAGTCAACCCCAATAATA
GTTGGTCCTGAACTGCGCGATAATAACCTG|AACTCCGCACGAGCCGTATCAGACTTGGCA
TGAACTGCGCGATAATAACCTGTGCAGGAG|ACGAGCCGTATCAGACTTGGCACCCTGAAT
GGTCACACGGTGATGAGCCGACCCTTGGTG|CTAAGTAGTAAACAATCCCGACGATAATAA
ACTAGTTTCGATGCCATCACATTTGGGGAG|GATAATAACCTGTGCAGGAGTCAACCCCAA
CTGTGCAGGAGTCAACCCCAAGACTTCACG|CTAGGCAACTAGATACCTAGTGTCTGCGAC
AGATAATTTCGGGCGGAATTCAAATGCGCA|TGATGGTCCCGAATCATAGTAACTGCACGA
GTCAACCCCAACCTATTCACGTCGTAATAC|CTGCCTCAACGAGCGGACACAGAAAAAGAT
AATAACCTGTGCAGGAGTCAACCCCAAACG|AATGTCGCCTCTTGTACCTCCAACGGCTTT
GAAACGTGTCACCTCGTAGCTACCGAGTAG|CTTCTATGGTACTTAGTACTGGCAAGACGC
ATAACCTGTGCAGGAGTCAACCCCAAACGC|ATGTCGCCTCTTGTACCTCCAACGGCTTTT
AAAATCGTTGGTCCTGAACTGCGCGATAAT|TCCGGCAACTCCGCACGAGCCGTATCAGAC
CACATTTGGGGAGGTGTCCGGCAACTCCGC|GAGTCAACCCCAACCTATTCACGTCGTAAT
TACAGCGGTACGATACAGAAGCTCGTTACC|AGTCGAACGAAGCTGTCGCATTTTGATAAT
GCCTCTTGTACCTCCAACGGCTTTTCTGTG|CGATAATAACCTGTGCAGGAGTCAACCCCA
GGCGGCGATAATAACCTGTGCAGGAGTGAT|TCCCCAACTCGCTATCCCAGAATCCGCATA
CGCATATATACAGCCATTTCGGAAGACAGG|ATAACCTGTGCAGGAGTCAACCCCAAACGC
GCAGGAGTCAACCCCAACCTATTCACGTCG|CGGTTTCTGCCTCAACGAGCGGACACAGAA
CTAACTAATTTATACTGGTCACACGGTGAT|CAACCCCAATTTCGAACTAAGTAGTAAACA
TGGGGTTTGCGTAACCCCACGGCCAGCTGT|CACCTCGTAGCTACCGAGTAGCTCTATCTT
AAATCGTTGGTCCTGAACTGCGCGATAATA|CCGGCAACTCCGCACGAGCCGTATCAGACT
TATACAGCCATTTCGGAAGACAGGCATTTA|TGTGCAGGAGTCAACCCCAAACGCATCTTG
GGTACTAAAGGTATGCCGCTCTAACTAATT|ATAATAACCTGTGCAGGAGTCAACCCCAAT
CTATCCCAGAATCCGCATATATACAGCCAT|GTACATCGAGATAATAACCTGTGCAGGAGT
AACGGTTTATGAGACGATGCTTGCGGGGCA|TGATAATAACCTGTGCAGGAGTCAACCCCA
TCCCAGAATCCGCATATATACAGCCATTTC|CATCGAGATAATAACCTGTGCAGGAGTCAA
CGAAACCGGTGATGGTCCCGAATCATAGTA|GTGCAGGAGTCAACCCCAATAATAACCTGT
ATAATAACCTGTGCAGGAGTCAACCCCAAC|CAGAAGGGAACGGTTTATGAGACGATGCTT
TGTCGCCTCTTGTACCTCCAACGGCTTTTC|TAACCGATAATAACCTGTGCAGGAGTCAAC
GAAACCGGTGATGGTCCCGAATCATAGTAA|TGCAGGAGTCAACCCCAATAATAACCTGTG
CTTGCGGGGCACCCGATGATAACGGCGCAA|AGTCAACCCCAAAGTGAATAAAAGAGATAA
GCCGACCCTTGGTGGTGACCTGGCCGTAAG|CCCGACGATAATAACCTGTGCAGGAGTCAA
AACAACCCCAACTGTTATTACAGCGGTACG|ATTTACGCCGGAGAAGAAAGTCGAACGAAG
GTCGCCTCTTGTACCTCCAACGGCTTTTCT|AACCGATAATAACCTGTGCAGGAGTCAACC
GGCTTTTCTGTGCCCGAAACCGGTGATGGT|GAGTCAACCCCAATGTGCAGGAGTCAACCC
GTGAATAAAAGAGATAATAACCGATAATAA|AGTGATAATAACCTGTGCAGGAGTCAACCC
CCCCATGCCGAATGCCTATTGGCGCCTGGT|ATAACCTGTGCAGGAGTCAACCCCAACGGA
GAGATAATTTCGGGCGGAATTCAAATGCGC|GTGATGGTCCCGAATCATAGTAACTGCACG
TATGCGGAGGTACTAAAGGTATGCCGCTCT|CACGCGCGATAATAACCTGTGCAGGAGTCA
TCACATTTGGGGAGGTGTCCGGCAACTCCG|GGAGTCAACCCCAACCTATTCACGTCGTAA
CAACCCCAACCTATTCACGTCGTAATACCG|GCCTCAACGAGCGGACACAGAAAAAGATCT
CCCCAAGAGAGTGGGGTTTGCGTAACCCCA|CAGAAACGTGTCACCTCGTAGCTACCGAGT
CCCAAGACTTCACGCGCGATAATAACCTGT|CTAGTGTCTGCGACGCTACAGTGAGCCTAC
CAGGAGTCAACCCCAACGGATTGGGTTTCT|TTTATGAGACGATGCTTGCGGGGCACCCGA
GTCTGCGACGCTACAGTGAGCCTACATCGG|AGTTTCGATGCCATCACATTTGGGGAGGTG
GTCCGGCAACTCCGCACGAGCCGTATCAGA|TATTCACGTCGTAATACCGCTACAACTTGC
CGTCGTAATACCGCTACAACTTGCTGAGTG|CAGAAAAAGATCTGACGTTGGCGCTTACAA
CCTGAATTGTTCAGAAACGTGTCACCTCGT|TTTCCACCGTGTTCTTCTATGGTACTTAGT
CCGTAAGTATCCGATAATAACCTGTGCAGG|GAGTCAACCCCAATAAAAAATCTAGGCAAC
GTGCAGGAGTCAACCCCAAGCCAACCACGC|AACTAATTTATACTGGTCACACGGTGATGA
GACGATGCTTGCGGGGCACCCGATGATAAC|GTGCAGGAGTCAACCCCAAAGTGAATAAAA
TGATGGTCCCGAATCATAGTAACTGCACGA|TCAACCCCAATAATAACCTGTGCAGGAGTC
ACTCGCTATCCCAGAATCCGCATATATACA|TTTCTGTACATCGAGATAATAACCTGTGCA
TGATAACGGCGCAATGTCGCCTCTTGTACC|AATAAAAGAGATAATAACCGATAATAACCT
ACCTGTGCAGGAGTCAACCCCAACAACCCC|CAGCCATTTCGGAAGACAGGCATTTACGCC
ATCGAGATAATAACCTGTGCAGGAGTCAAC|AACGGCGCAATGTCGCCTCTTGTACCTCCA
CTAAAGGTATGCCGCTCTAACTAATTTATA|TAACCTGTGCAGGAGTCAACCCCAATTTCG
AACTGTTATTACAGCGGTACGATACAGAAG|GGAGAAGAAAGTCGAACGAAGCTGTCGCAT
TGTGCAGGAGTCAACCCCAACGGATTGGGT|ACGGTTTATGAGACGATGCTTGCGGGGCAC
AAAAATCTAGGCAACTAGATACCTAGTGTC|CCCCACGGCCAGCTGTCTTACCGGACTAGT
TGCAGGAGTCAACCCCAAAGTGAATAAAAG|GGATAATAACCTGTGCAGGAGTGATAATAA
TGTCTTACCGGACTAGTTTCGATGCCATCA|CTTAGTTTTTTGATAATAACCTGTGCAGGA
TGTGCAGGAGTCAACCCCAACAACCCCAAT|TCCGATAATAACCTGTGCAGGAGTCAACCC
GCGGAGGTACTAAAGGTATGCCGCTCTAAC|GCGCGATAATAACCTGTGCAGGAGTCAACC
TGCGCGATAATAACCTGTGCAGGAGTCAAC|CCGTATCAGACTTGGCACCCTGAATTGTTC
CCTGTGCAGGAGTCAACCCCAATGTGCAGG|CAACAACCCCAATACGACGGCTATGCGGAG
GCAGGAGTCAACCCCAAAGTGAATAAAAGA|GATAATAACCTGTGCAGGAGTGATAATAAC
TCGATGAAGTGCGCGGCGGCGATAATAACC|CTATTGGCGCCTGGTCCCCAACTCGCTATC
GAGTGGGGTTTGCGTAACCCCACGGCCAGC|TGTCACCTCGTAGCTACCGAGTAGCTCTAT
TCTGTGCCCGAAACCGGTGATGGTCCCGAA|ACCCCAATGTGCAGGAGTCAACCCCAATAA
GAGCCGACCCTTGGTGGTGACCTGGCCGTA|ATCCCGACGATAATAACCTGTGCAGGAGTC
CCCCAAGCCAACCACGCGGATAATAACCTG|TGGTCACACGGTGATGAGCCGACCCTTGGT
AGCCTACATCGGAAAATCGTTGGTCCTGAA|TTTGGGGAGGTGTCCGGCAACTCCGCACGA
ATCGTTGGTCCTGAACTGCGCGATAATAAC|GGCAACTCCGCACGAGCCGTATCAGACTTG
GTCCCCAACTCGCTATCCCAGAATCCGCAT|GATTGGGTTTCTGTACATCGAGATAATAAC
CGTAGCTACCGAGTAGCTCTATCTTAGTTT|AGTACTGGCAAGACGCATGTACCTAATCAT
AGGAGTGATAATAACCTGTGCAGGAGTCAA|ATCCGCATATATACAGCCATTTCGGAAGAC
ATCCCAGAATCCGCATATATACAGCCATTT|ACATCGAGATAATAACCTGTGCAGGAGTCA
CAGCTGTCTTACCGGACTAGTTTCGATGCC|CTATCTTAGTTTTTTGATAATAACCTGTGC
TTGCGTAACCCCACGGCCAGCTGTCTTACC|GTAGCTACCGAGTAGCTCTATCTTAGTTTT
ACCTGTGCAGGAGTCAACCCCAACGGATTG|GGAACGGTTTATGAGACGATGCTTGCGGGG
CAACCCCAACTGTTATTACAGCGGTACGAT|TTACGCCGGAGAAGAAAGTCGAACGAAGCT
CAGAAGGGAACGGTTTATGAGACGATGCTT|GAAAACCGTGATAATAACCTGTGCAGGAGT
AGTAGCTCTATCTTAGTTTTTTGATAATAA|GACGCATGTACCTAATCATACAGCAGTGAC
AACTAATTTATACTGGTCACACGGTGATGA|ACCCCAATTTCGAACTAAGTAGTAAACAAT
GCGATAATAACCTGTGCAGGAGTCAACCCC|TATCAGACTTGGCACCCTGAATTGTTCAGA
ACGGTGATGAGCCGACCCTTGGTGGTGACC|AGTAAACAATCCCGACGATAATAACCTGTG
AACCCCAACCTATTCACGTCGTAATACCGC|CCTCAACGAGCGGACACAGAAAAAGATCTG
GTATCCGATAATAACCTGTGCAGGAGTCAA|ACCCCAATAAAAAATCTAGGCAACTAGATA
GGAGTCAACCCCAACGGATTGGGTTTCTGT|TATGAGACGATGCTTGCGGGGCACCCGATG
AAAACCGTGATAATAACCTGTGCAGGAGTC|CAACCCCAAGCCAACCACGCGGATAATAAC
ACGGCTTTTCTGTGCCCGAAACCGGTGATG|AGGAGTCAACCCCAATGTGCAGGAGTCAAC
GAAGGGAACGGTTTATGAGACGATGCTTGC|AAACCGTGATAATAACCTGTGCAGGAGTCA
GCCATTTCGGAAGACAGGCATTTACGCCGG|GGAGTCAACCCCAAACGCATCTTGTGTCCG
TAACGGCGCAATGTCGCCTCTTGTACCTCC|AAAAGAGATAATAACCGATAATAACCTGTG
CCTGTGCAGGAGTCAACCCCAAACGCATCT|CGCCTCTTGTACCTCCAACGGCTTTTCTGT
GTCACCTCGTAGCTACCGAGTAGCTCTATC|GGTACTTAGTACTGGCAAGACGCATGTACC
TCCCCAACTCGCTATCCCAGAATCCGCATA|ATTGGGTTTCTGTACATCGAGATAATAACC
ACCTGTGCAGGAGTCAACCCCAAGAGAGTG|TGGCACCCTGAATTGTTCAGAAACGTGTCA
GAGTAGATGGTCGTTCGATGAAGTGCGCGG|CCCATGCCGAATGCCTATTGGCGCCTGGTC
CGCGGATAATAACCTGTGCAGGAGTGATAA|TGAGCCGACCCTTGGTGGTGACCTGGCCGT
AGTGATAATAACCTGTGCAGGAGTCAACCC|CGCATATATACAGCCATTTCGGAAGACAGG
GTGCAGGAGTCAACCCCAAGACTTCACGCG|AGGCAACTAGATACCTAGTGTCTGCGACGC
TCGGAAAATCGTTGGTCCTGAACTGCGCGA|GGTGTCCGGCAACTCCGCACGAGCCGTATC
CAAATGCGCAGAAGGGAACGGTTTATGAGA|AACTGCACGAAAACCGTGATAATAACCTGT
CGAAGCTGTCGCATTTTGATAATAACCTGT|GGGCGGAATTCAAATGCGCAGAAGGGAACG
AATAATAACCTGTGCAGGAGTCAACCCCAA|TATGCCGCTCTAACTAATTTATACTGGTCA
GTAGTAAACAATCCCGACGATAATAACCTG|CGATAATAACCTGTGCAGGAGTCAACCCCA
ACCCCAACAACCCCAACTGTTATTACAGCG|CAGGCATTTACGCCGGAGAAGAAAGTCGAA
TAATAACCTGTGCAGGAGTCAACCCCAAGC|TGCCGCTCTAACTAATTTATACTGGTCACA
TCTTGTACCTCCAACGGCTTTTCTGTGCCC|TAATAACCTGTGCAGGAGTCAACCCCAATG
CAACCCCAATAAAAAATCTAGGCAACTAGA|GGTTTGCGTAACCCCACGGCCAGCTGTCTT
TTGTACCTCCAACGGCTTTTCTGTGCCCGA|ATAACCTGTGCAGGAGTCAACCCCAATGTG
CAGAATCCGCATATATACAGCCATTTCGGA|CGAGATAATAACCTGTGCAGGAGTCAACCC
GCGGAATTCAAATGCGCAGAAGGGAACGGT|ATCATAGTAACTGCACGAAAACCGTGATAA
TCACACGGTGATGAGCCGACCCTTGGTGGT|AAGTAGTAAACAATCCCGACGATAATAACC
GCAGGAGTCAACCCCAAGAGAGTGGGGTTT|CCTGAATTGTTCAGAAACGTGTCACCTCGT
GGAGTCAACCCCAACAACCCCAACTGTTAT|CGGAAGACAGGCATTTACGCCGGAGAAGAA
GAGAGTGGGGTTTGCGTAACCCCACGGCCA|CGTGTCACCTCGTAGCTACCGAGTAGCTCT
TAATAACCTGTGCAGGAGTCAACCCCAACA|ATATACAGCCATTTCGGAAGACAGGCATTT
TAACCTGTGCAGGAGTCAACCCCAATAAAA|AACCCCAAGAGAGTGGGGTTTGCGTAACCC
ACGAGCCGTATCAGACTTGGCACCCTGAAT|ACCGCTACAACTTGCTGAGTGGCTTTCCAC
TCAAATGCGCAGAAGGGAACGGTTTATGAG|TAACTGCACGAAAACCGTGATAATAACCTG
CTGTGCAGGAGTGATAATAACCTGTGCAGG|CCCAGAATCCGCATATATACAGCCATTTCG
CGCATTTTGATAATAACCTGTGCAGGAGTC|TCAAATGCGCAGAAGGGAACGGTTTATGAG
TGTGCAGGAGTCAACCCCAAGAGAGTGGGG|CACCCTGAATTGTTCAGAAACGTGTCACCT
TCCGCATATATACAGCCATTTCGGAAGACA|TAATAACCTGTGCAGGAGTCAACCCCAAAC
AAGTGAATAAAAGAGATAATAACCGATAAT|GGAGTGATAATAACCTGTGCAGGAGTCAAC
CCCCAATTTCGAACTAAGTAGTAAACAATC|GTTGGTCCTGAACTGCGCGATAATAACCTG
ATGTGCAGGAGTCAACCCCAATAATAACCT|TATGCGGAGGTACTAAAGGTATGCCGCTCT
GGAGTCAACCCCAAAGTGAATAAAAGAGAT|AATAACCTGTGCAGGAGTGATAATAACCTG
ACTAATTTATACTGGTCACACGGTGATGAG|CCCCAATTTCGAACTAAGTAGTAAACAATC
TTGATAATAACCTGTGCAGGAGTCAACCCC|GCGCAGAAGGGAACGGTTTATGAGACGATG
TAATTTATACTGGTCACACGGTGATGAGCC|CCAATTTCGAACTAAGTAGTAAACAATCCC
CCGTTTGAGATAATTTCGGGCGGAATTCAA|AAACCGGTGATGGTCCCGAATCATAGTAAC
ATGCCTATTGGCGCCTGGTCCCCAACTCGC|AGGAGTCAACCCCAACGGATTGGGTTTCTG
TTGGTGGTGACCTGGCCGTAAGTATCCGAT|TAATAACCTGTGCAGGAGTCAACCCCAATA
ACCTGTGCAGGAGTCAACCCCAATTTCGAA|GCCTACATCGGAAAATCGTTGGTCCTGAAC
AGTGGGGTTTGCGTAACCCCACGGCCAGCT|GTCACCTCGTAGCTACCGAGTAGCTCTATC
TCGTAGCTACCGAGTAGCTCTATCTTAGTT|TAGTACTGGCAAGACGCATGTACCTAATCA
TCAACCCCAATGTGCAGGAGTCAACCCCAA|TACGACGGCTATGCGGAGGTACTAAAGGTA
CCGGTGATGGTCCCGAATCATAGTAACTGC|GGAGTCAACCCCAATAATAACCTGTGCAGG
CGCGATAATAACCTGTGCAGGAGTCAACCC|GCTACAGTGAGCCTACATCGGAAAATCGTT
GCAATGTCGCCTCTTGTACCTCCAACGGCT|ATAATAACCGATAATAACCTGTGCAGGAGT
TACCGGACTAGTTTCGATGCCATCACATTT|TTTTTTGATAATAACCTGTGCAGGAGTCAA
CACGCGCGATAATAACCTGTGCAGGAGTCA|CGACGCTACAGTGAGCCTACATCGGAAAAT
GATGAGCCGACCCTTGGTGGTGACCTGGCC|ACAATCCCGACGATAATAACCTGTGCAGGA
CTTGGTGGTGACCTGGCCGTAAGTATCCGA|ATAATAACCTGTGCAGGAGTCAACCCCAAT
AGTAGATGGTCGTTCGATGAAGTGCGCGGC|CCATGCCGAATGCCTATTGGCGCCTGGTCC
TCCGGCAACTCCGCACGAGCCGTATCAGAC|ATTCACGTCGTAATACCGCTACAACTTGCT
TAACCTGTGCAGGAGTCAACCCCAAGCCAA|CGCTCTAACTAATTTATACTGGTCACACGG
GAAGAAAGTCGAACGAAGCTGTCGCATTTT|TTGAGATAATTTCGGGCGGAATTCAAATGC
GCGGGGCACCCGATGATAACGGCGCAATGT|CAACCCCAAAGTGAATAAAAGAGATAATAA
CAGGAGTCAACCCCAACCTATTCACGTCGT|GGTTTCTGCCTCAACGAGCGGACACAGAAA
GCTGTCTTACCGGACTAGTTTCGATGCCAT|ATCTTAGTTTTTTGATAATAACCTGTGCAG
GGAGTCAACCCCAAGACTTCACGCGCGATA|ACTAGATACCTAGTGTCTGCGACGCTACAG
AACCCCAACAACCCCAACTGTTATTACAGC|ACAGGCATTTACGCCGGAGAAGAAAGTCGA
AGGCATTTACGCCGGAGAAGAAAGTCGAAC|CGCATCTTGTGTCCGTTTGAGATAATTTCG
AATAACCTGTGCAGGAGTCAACCCCAACCT|GTGACCGAAGCGGTTTCTGCCTCAACGAGC
ACCCCAATTTCGAACTAAGTAGTAAACAAT|CGTTGGTCCTGAACTGCGCGATAATAACCT
TTGGCGCCTGGTCCCCAACTCGCTATCCCA|AACCCCAACGGATTGGGTTTCTGTACATCG
ATCTTGTGTCCGTTTGAGATAATTTCGGGC|CTGTGCCCGAAACCGGTGATGGTCCCGAAT
TGCAGGAGTCAACCCCAACAACCCCAACTG|ATTTCGGAAGACAGGCATTTACGCCGGAGA
CGTTACCCCATGCCGAATGCCTATTGGCGC|TGATAATAACCTGTGCAGGAGTCAACCCCA
ATAATAACCTGTGCAGGAGTCAACCCCAAC|CAGTGACCGAAGCGGTTTCTGCCTCAACGA
CTGTGCAGGAGTCAACCCCAACAACCCCAA|GCCATTTCGGAAGACAGGCATTTACGCCGG
GTGGGGTTTGCGTAACCCCACGGCCAGCTG|TCACCTCGTAGCTACCGAGTAGCTCTATCT
TTCGGAAGACAGGCATTTACGCCGGAGAAG|CAACCCCAAACGCATCTTGTGTCCGTTTGA
ACCCCAATACGACGGCTATGCGGAGGTACT|GTCAACCCCAAGACTTCACGCGCGATAATA
GTCAACCCCAATAATAACCTGTGCAGGAGT|TACTAAAGGTATGCCGCTCTAACTAATTTA
TAACCTGTGCAGGAGTCAACCCCAAGACTT|AAATCTAGGCAACTAGATACCTAGTGTCTG
GGGGAGGTGTCCGGCAACTCCGCACGAGCC|CCCCAACCTATTCACGTCGTAATACCGCTA
GAGTCAACCCCAACAACCCCAATACGACGG|ATAACCTGTGCAGGAGTCAACCCCAAGACT
CCAACGGATTGGGTTTCTGTACATCGAGAT|TGCTTGCGGGGCACCCGATGATAACGGCGC
GAGTCAACCCCAAACGCATCTTGTGTCCGT|TACCTCCAACGGCTTTTCTGTGCCCGAAAC
TGAATAAAAGAGATAATAACCGATAATAAC|GTGATAATAACCTGTGCAGGAGTCAACCCC
CTGTGCAGGAGTCAACCCCAAACGCATCTT|GCCTCTTGTACCTCCAACGGCTTTTCTGTG
CTGGCCGTAAGTATCCGATAATAACCTGTG|GCAGGAGTCAACCCCAATAAAAAATCTAGG
GGAGGTACTAAAGGTATGCCGCTCTAACTA|GCGATAATAACCTGTGCAGGAGTCAACCCC
AGAGAGTGGGGTTTGCGTAACCCCACGGCC|ACGTGTCACCTCGTAGCTACCGAGTAGCTC
GCAGGAGTCAACCCCAATGTGCAGGAGTCA|ACCCCAATACGACGGCTATGCGGAGGTACT
AGTATCCGATAATAACCTGTGCAGGAGTCA|AACCCCAATAAAAAATCTAGGCAACTAGAT
ATACCTAGTGTCTGCGACGCTACAGTGAGC|TACCGGACTAGTTTCGATGCCATCACATTT
CCAAAGTGAATAAAAGAGATAATAACCGAT|GCAGGAGTGATAATAACCTGTGCAGGAGTC
TAAACAATCCCGACGATAATAACCTGTGCA|AATAACCTGTGCAGGAGTCAACCCCAAGAG
ATGCCATCACATTTGGGGAGGTGTCCGGCA|TGTGCAGGAGTCAACCCCAACCTATTCACG
TGAGACGATGCTTGCGGGGCACCCGATGAT|CCTGTGCAGGAGTCAACCCCAAAGTGAATA
GAACTAAGTAGTAAACAATCCCGACGATAA|AACTGCGCGATAATAACCTGTGCAGGAGTC
AGTCGAACGAAGCTGTCGCATTTTGATAAT|TAATTTCGGGCGGAATTCAAATGCGCAGAA
ACCGAGTAGCTCTATCTTAGTTTTTTGATA|GCAAGACGCATGTACCTAATCATACAGCAG
CCAACGGCTTTTCTGTGCCCGAAACCGGTG|TGCAGGAGTCAACCCCAATGTGCAGGAGTC
AATTGTTCAGAAACGTGTCACCTCGTAGCT|CACCGTGTTCTTCTATGGTACTTAGTACTG
AGGAGTCAACCCCAAGCCAACCACGCGGAT|AATTTATACTGGTCACACGGTGATGAGCCG
GTAGCTACCGAGTAGCTCTATCTTAGTTTT|GTACTGGCAAGACGCATGTACCTAATCATA
GTCAACCCCAACAACCCCAATACGACGGCT|AACCTGTGCAGGAGTCAACCCCAAGACTTC
GATAATAACCTGTGCAGGAGTCAACCCCAA|GAGTCAACCCCAAGAGAGTGGGGTTTGCGT
TAATAACCTGTGCAGGAGTGATAATAACCT|GACCCTTGGTGGTGACCTGGCCGTAAGTAT
GTCTTACCGGACTAGTTTCGATGCCATCAC|TTAGTTTTTTGATAATAACCTGTGCAGGAG
AGCTACCGAGTAGCTCTATCTTAGTTTTTT|ACTGGCAAGACGCATGTACCTAATCATACA
CCAATAATAACCTGTGCAGGAGTCAACCCC|GGTATGCCGCTCTAACTAATTTATACTGGT
TAACCTGTGCAGGAGTCAACCCCAATTTCG|GAGCCTACATCGGAAAATCGTTGGTCCTGA
TCGCCTCTTGTACCTCCAACGGCTTTTCTG|ACCGATAATAACCTGTGCAGGAGTCAACCC
GCCGCTCTAACTAATTTATACTGGTCACAC|AGGAGTCAACCCCAATTTCGAACTAAGTAG
ACCCCAACTGTTATTACAGCGGTACGATAC|ACGCCGGAGAAGAAAGTCGAACGAAGCTGT
AGGTATGCCGCTCTAACTAATTTATACTGG|CTGTGCAGGAGTCAACCCCAATTTCGAACT
ATACAGCCATTTCGGAAGACAGGCATTTAC|GTGCAGGAGTCAACCCCAAACGCATCTTGT
GGAGTGATAATAACCTGTGCAGGAGTCAAC|TCCGCATATATACAGCCATTTCGGAAGACA
CGCGGCGGCGATAATAACCTGTGCAGGAGT|TGGTCCCCAACTCGCTATCCCAGAATCCGC
CATTTTGATAATAACCTGTGCAGGAGTCAA|AAATGCGCAGAAGGGAACGGTTTATGAGAC
ATAACCGATAATAACCTGTGCAGGAGTCAA|GCAGGAGTCAACCCCAACAACCCCAATACG
ACCTGTGCAGGAGTCAACCCCAAACGCATC|TCGCCTCTTGTACCTCCAACGGCTTTTCTG
GAGTGATAATAACCTGTGCAGGAGTCAACC|CCTGGCCGTAAGTATCCGATAATAACCTGT
TGCAGGAGTCAACCCCAAACGCATCTTGTG|TCTTGTACCTCCAACGGCTTTTCTGTGCCC
GAAAACCGTGATAATAACCTGTGCAGGAGT|TCAACCCCAAGCCAACCACGCGGATAATAA
CCCCAATAAAAAATCTAGGCAACTAGATAC|TTGCGTAACCCCACGGCCAGCTGTCTTACC
AAATCTAGGCAACTAGATACCTAGTGTCTG|CCACGGCCAGCTGTCTTACCGGACTAGTTT
AACCTGTGCAGGAGTGATAATAACCTGTGC|CTTGGTGGTGACCTGGCCGTAAGTATCCGA
ACTGCGCGATAATAACCTGTGCAGGAGTCA|AGCCGTATCAGACTTGGCACCCTGAATTGT
ACAGCCATTTCGGAAGACAGGCATTTACGC|GCAGGAGTCAACCCCAAACGCATCTTGTGT
GTGCAGGAGTCAACCCCAACGGATTGGGTT|CGGTTTATGAGACGATGCTTGCGGGGCACC
CGACGCTACAGTGAGCCTACATCGGAAAAT|CGATGCCATCACATTTGGGGAGGTGTCCGG
TAACCTGTGCAGGAGTCAACCCCAACGGAT|AGGGAACGGTTTATGAGACGATGCTTGCGG
ATGCCGCTCTAACTAATTTATACTGGTCAC|GCAGGAGTCAACCCCAATTTCGAACTAAGT
TGGTCCCGAATCATAGTAACTGCACGAAAA|ACCCCAATAATAACCTGTGCAGGAGTCAAC
TTCACGCGCGATAATAACCTGTGCAGGAGT|TGCGACGCTACAGTGAGCCTACATCGGAAA
AGTCAACCCCAATGTGCAGGAGTCAACCCC|AATACGACGGCTATGCGGAGGTACTAAAGG
CTGCGACGCTACAGTGAGCCTACATCGGAA|TTTCGATGCCATCACATTTGGGGAGGTGTC
TGCAGGAGTCAACCCCAACAACCCCAATAC|CGATAATAACCTGTGCAGGAGTCAACCCCA
CGGACTAGTTTCGATGCCATCACATTTGGG|TTTGATAATAACCTGTGCAGGAGTCAACCC
ACCCCAACAACCCCAATACGACGGCTATGC|TGTGCAGGAGTCAACCCCAAGACTTCACGC
GTGCAGGAGTGATAATAACCTGTGCAGGAG|CAGAATCCGCATATATACAGCCATTTCGGA
ACCCCAAGAGAGTGGGGTTTGCGTAACCCC|TCAGAAACGTGTCACCTCGTAGCTACCGAG
CTGTGCAGGAGTCAACCCCAAGAGAGTGGG|GCACCCTGAATTGTTCAGAAACGTGTCACC
AGGCAACTAGATACCTAGTGTCTGCGACGC|CCAGCTGTCTTACCGGACTAGTTTCGATGC
ATTTGGGGAGGTGTCCGGCAACTCCGCACG|TCAACCCCAACCTATTCACGTCGTAATACC
CCTGTGCAGGAGTCAACCCCAAGCCAACCA|TCTAACTAATTTATACTGGTCACACGGTGA
GGACTAGTTTCGATGCCATCACATTTGGGG|TTGATAATAACCTGTGCAGGAGTCAACCCC
CAGCGGTACGATACAGAAGCTCGTTACCCC|TCGAACGAAGCTGTCGCATTTTGATAATAA
CCACGCGGATAATAACCTGTGCAGGAGTGA|TGATGAGCCGACCCTTGGTGGTGACCTGGC
CAGTGAGCCTACATCGGAAAATCGTTGGTC|TCACATTTGGGGAGGTGTCCGGCAACTCCG
AGAATCCGCATATATACAGCCATTTCGGAA|GAGATAATAACCTGTGCAGGAGTCAACCCC
GAGTCAACCCCAAGACTTCACGCGCGATAA|CTAGATACCTAGTGTCTGCGACGCTACAGT
GCCCGAAACCGGTGATGGTCCCGAATCATA|AATGTGCAGGAGTCAACCCCAATAATAACC
AAATGCGCAGAAGGGAACGGTTTATGAGAC|ACTGCACGAAAACCGTGATAATAACCTGTG
AACCCCAAGACTTCACGCGCGATAATAACC|TACCTAGTGTCTGCGACGCTACAGTGAGCC
GGCCAGCTGTCTTACCGGACTAGTTTCGAT|GCTCTATCTTAGTTTTTTGATAATAACCTG
TGTGCAGGAGTCAACCCCAACAACCCCAAC|CCATTTCGGAAGACAGGCATTTACGCCGGA
ATAACCTGTGCAGGAGTCAACCCCAAGCCA|CCGCTCTAACTAATTTATACTGGTCACACG
TAATAACCTGTGCAGGAGTCAACCCCAAGA|AAAAAATCTAGGCAACTAGATACCTAGTGT
AATGTGCAGGAGTCAACCCCAATAATAACC|CTATGCGGAGGTACTAAAGGTATGCCGCTC
CCCCAACTCGCTATCCCAGAATCCGCATAT|TTGGGTTTCTGTACATCGAGATAATAACCT
CAAAGTGAATAAAAGAGATAATAACCGATA|CAGGAGTGATAATAACCTGTGCAGGAGTCA
GAGTCAACCCCAATGTGCAGGAGTCAACCC|CAATACGACGGCTATGCGGAGGTACTAAAG
CCCAAAGTGAATAAAAGAGATAATAACCGA|TGCAGGAGTGATAATAACCTGTGCAGGAGT
TTAGTTTTTTGATAATAACCTGTGCAGGAG|TAATCATACAGCAGTGACCGAAGCGGTTTC
TCTTACCGGACTAGTTTCGATGCCATCACA|TAGTTTTTTGATAATAACCTGTGCAGGAGT
GTGCAGGAGTCAACCCCAACAACCCCAACT|CATTTCGGAAGACAGGCATTTACGCCGGAG
CCAGAATCCGCATATATACAGCCATTTCGG|TCGAGATAATAACCTGTGCAGGAGTCAACC
ATAACCTGTGCAGGAGTCAACCCCAACCTA|TGACCGAAGCGGTTTCTGCCTCAACGAGCG
CGGCCAGCTGTCTTACCGGACTAGTTTCGA|AGCTCTATCTTAGTTTTTTGATAATAACCT
CGCCTGGTCCCCAACTCGCTATCCCAGAAT|CCAACGGATTGGGTTTCTGTACATCGAGAT
AAAGGTATGCCGCTCTAACTAATTTATACT|ACCTGTGCAGGAGTCAACCCCAATTTCGAA
AACCTGTGCAGGAGTCAACCCCAACGGATT|GGGAACGGTTTATGAGACGATGCTTGCGGG
TGCAGGAGTCAACCCCAATAATAACCTGTG|GCGGAGGTACTAAAGGTATGCCGCTCTAAC
TCGGAAGACAGGCATTTACGCCGGAGAAGA|AACCCCAAACGCATCTTGTGTCCGTTTGAG
CAACTCCGCACGAGCCGTATCAGACTTGGC|CGTCGTAATACCGCTACAACTTGCTGAGTG
CGGAGTAGATGGTCGTTCGATGAAGTGCGC|ACCCCATGCCGAATGCCTATTGGCGCCTGG
ATGAGCCGACCCTTGGTGGTGACCTGGCCG|CAATCCCGACGATAATAACCTGTGCAGGAG
TGCACGAAAACCGTGATAATAACCTGTGCA|AGGAGTCAACCCCAAGCCAACCACGCGGAT
TTATGAGACGATGCTTGCGGGGCACCCGAT|TAACCTGTGCAGGAGTCAACCCCAAAGTGA
AGTCAACCCCAATTTCGAACTAAGTAGTAA|AAAATCGTTGGTCCTGAACTGCGCGATAAT
ACCCTGAATTGTTCAGAAACGTGTCACCTC|GCTTTCCACCGTGTTCTTCTATGGTACTTA
GATAATAACCTGTGCAGGAGTCAACCCCAA|ATAAAAAATCTAGGCAACTAGATACCTAGT
AATAACCGATAATAACCTGTGCAGGAGTCA|TGCAGGAGTCAACCCCAACAACCCCAATAC
AACCCCAACGGATTGGGTTTCTGTACATCG|ACGATGCTTGCGGGGCACCCGATGATAACG
CCTGTGCAGGAGTCAACCCCAAGAGAGTGG|GGCACCCTGAATTGTTCAGAAACGTGTCAC
AACCTGTGCAGGAGTCAACCCCAAGAGAGT|TTGGCACCCTGAATTGTTCAGAAACGTGTC
CGCCGGAGAAGAAAGTCGAACGAAGCTGTC|TGTCCGTTTGAGATAATTTCGGGCGGAATT
TAACCTGTGCAGGAGTGATAATAACCTGTG|CTATCCCAGAATCCGCATATATACAGCCAT
AAAAGAGATAATAACCGATAATAACCTGTG|AATAACCTGTGCAGGAGTCAACCCCAACAA
GAATAAAAGAGATAATAACCGATAATAACC|TGATAATAACCTGTGCAGGAGTCAACCCCA
AACCCCACGGCCAGCTGTCTTACCGGACTA|ACCGAGTAGCTCTATCTTAGTTTTTTGATA
TATATACAGCCATTTCGGAAGACAGGCATT|CCTGTGCAGGAGTCAACCCCAAACGCATCT
ATAATAACCTGTGCAGGAGTCAACCCCAAT|AGTCAACCCCAAGAGAGTGGGGTTTGCGTA
ATAATAACCGATAATAACCTGTGCAGGAGT|TGTGCAGGAGTCAACCCCAACAACCCCAAT
TAATAACCTGTGCAGGAGTCAACCCCAACA|CGTAAGTATCCGATAATAACCTGTGCAGGA
TCGAGATAATAACCTGTGCAGGAGTCAACC|ACGGCGCAATGTCGCCTCTTGTACCTCCAA
TGCAGGAGTCAACCCCAAGACTTCACGCGC|GGCAACTAGATACCTAGTGTCTGCGACGCT
CGATAATAACCTGTGCAGGAGTCAACCCCA|ATCAGACTTGGCACCCTGAATTGTTCAGAA
ATGCGGAGGTACTAAAGGTATGCCGCTCTA|ACGCGCGATAATAACCTGTGCAGGAGTCAA
GTTTGCGTAACCCCACGGCCAGCTGTCTTA|TCGTAGCTACCGAGTAGCTCTATCTTAGTT
CTAAGTAGTAAACAATCCCGACGATAATAA|TGCGCGATAATAACCTGTGCAGGAGTCAAC
CCCTGAATTGTTCAGAAACGTGTCACCTCG|CTTTCCACCGTGTTCTTCTATGGTACTTAG
ATTGGGTTTCTGTACATCGAGATAATAACC|GGGGCACCCGATGATAACGGCGCAATGTCG
TGTACCTCCAACGGCTTTTCTGTGCCCGAA|TAACCTGTGCAGGAGTCAACCCCAATGTGC
TACTGGTCACACGGTGATGAGCCGACCCTT|CGAACTAAGTAGTAAACAATCCCGACGATA
AATTTCGAACTAAGTAGTAAACAATCCCGA|GTCCTGAACTGCGCGATAATAACCTGTGCA
GTGCAGGAGTCAACCCCAATTTCGAACTAA|ACATCGGAAAATCGTTGGTCCTGAACTGCG
CTGTTATTACAGCGGTACGATACAGAAGCT|AGAAGAAAGTCGAACGAAGCTGTCGCATTT
ATAACCTGTGCAGGAGTCAACCCCAACAAC|ATACAGCCATTTCGGAAGACAGGCATTTAC
GTGATAATAACCTGTGCAGGAGTCAACCCC|TGGCCGTAAGTATCCGATAATAACCTGTGC
GTGGTGACCTGGCCGTAAGTATCCGATAAT|TAACCTGTGCAGGAGTCAACCCCAATAAAA
CCTGAACTGCGCGATAATAACCTGTGCAGG|GCACGAGCCGTATCAGACTTGGCACCCTGA
GACCTGGCCGTAAGTATCCGATAATAACCT|TGTGCAGGAGTCAACCCCAATAAAAAATCT
CTTGTGTCCGTTTGAGATAATTTCGGGCGG|GTGCCCGAAACCGGTGATGGTCCCGAATCA
TGCGCGGCGGCGATAATAACCTGTGCAGGA|CCTGGTCCCCAACTCGCTATCCCAGAATCC
GGCGGAATTCAAATGCGCAGAAGGGAACGG|AATCATAGTAACTGCACGAAAACCGTGATA
GCAACTCCGCACGAGCCGTATCAGACTTGG|ACGTCGTAATACCGCTACAACTTGCTGAGT
GGAGTGATAATAACCTGTGCAGGAGTCAAC|ACCTGGCCGTAAGTATCCGATAATAACCTG
GCTCTAACTAATTTATACTGGTCACACGGT|AGTCAACCCCAATTTCGAACTAAGTAGTAA
TCACGTCGTAATACCGCTACAACTTGCTGA|ACACAGAAAAAGATCTGACGTTGGCGCTTA
AGAAACGTGTCACCTCGTAGCTACCGAGTA|TCTTCTATGGTACTTAGTACTGGCAAGACG
GCACCCGATGATAACGGCGCAATGTCGCCT|CCAAAGTGAATAAAAGAGATAATAACCGAT
AACCCCAAAGTGAATAAAAGAGATAATAAC|CTGTGCAGGAGTGATAATAACCTGTGCAGG
ACCTGGCCGTAAGTATCCGATAATAACCTG|GTGCAGGAGTCAACCCCAATAAAAAATCTA
TACAGCCATTTCGGAAGACAGGCATTTACG|TGCAGGAGTCAACCCCAAACGCATCTTGTG
CTTAGTTTTTTGATAATAACCTGTGCAGGA|CTAATCATACAGCAGTGACCGAAGCGGTTT
GCGTAACCCCACGGCCAGCTGTCTTACCGG|AGCTACCGAGTAGCTCTATCTTAGTTTTTT
AAACCGTGATAATAACCTGTGCAGGAGTCA|AACCCCAAGCCAACCACGCGGATAATAACC
AACCACGCGGATAATAACCTGTGCAGGAGT|GGTGATGAGCCGACCCTTGGTGGTGACCTG
GTTACCCCATGCCGAATGCCTATTGGCGCC|GATAATAACCTGTGCAGGAGTCAACCCCAA
ATCGGAAAATCGTTGGTCCTGAACTGCGCG|AGGTGTCCGGCAACTCCGCACGAGCCGTAT
GACGGCTATGCGGAGGTACTAAAGGTATGC|AGACTTCACGCGCGATAATAACCTGTGCAG
CAACCCCAATGTGCAGGAGTCAACCCCAAT|ACGACGGCTATGCGGAGGTACTAAAGGTAT
GATGGTCGTTCGATGAAGTGCGCGGCGGCG|GCCGAATGCCTATTGGCGCCTGGTCCCCAA
CGAATCATAGTAACTGCACGAAAACCGTGA|ATAATAACCTGTGCAGGAGTCAACCCCAAG
ATCCGATAATAACCTGTGCAGGAGTCAACC|CCCAATAAAAAATCTAGGCAACTAGATACC
ATGCTTGCGGGGCACCCGATGATAACGGCG|AGGAGTCAACCCCAAAGTGAATAAAAGAGA
TGTGCAGGAGTCAACCCCAATAATAACCTG|ATGCGGAGGTACTAAAGGTATGCCGCTCTA
TGTGCAGGAGTCAACCCCAACCTATTCACG|AAGCGGTTTCTGCCTCAACGAGCGGACACA
AACGCATCTTGTGTCCGTTTGAGATAATTT|CTTTTCTGTGCCCGAAACCGGTGATGGTCC
CTGAACTGCGCGATAATAACCTGTGCAGGA|CACGAGCCGTATCAGACTTGGCACCCTGAA
GATGGTCCCGAATCATAGTAACTGCACGAA|CAACCCCAATAATAACCTGTGCAGGAGTCA
CGGAAGACAGGCATTTACGCCGGAGAAGAA|ACCCCAAACGCATCTTGTGTCCGTTTGAGA
TATTCACGTCGTAATACCGCTACAACTTGC|CGGACACAGAAAAAGATCTGACGTTGGCGC
GTGCAGGAGTCAACCCCAACAACCCCAATA|CCGATAATAACCTGTGCAGGAGTCAACCCC
ATTGGCGCCTGGTCCCCAACTCGCTATCCC|CAACCCCAACGGATTGGGTTTCTGTACATC
GGGAGGTGTCCGGCAACTCCGCACGAGCCG|CCCAACCTATTCACGTCGTAATACCGCTAC
TCGTTACCCCATGCCGAATGCCTATTGGCG|TTGATAATAACCTGTGCAGGAGTCAACCCC
ATAGTAACTGCACGAAAACCGTGATAATAA|ACCTGTGCAGGAGTCAACCCCAAGCCAACC
GCGACGCTACAGTGAGCCTACATCGGAAAA|TCGATGCCATCACATTTGGGGAGGTGTCCG
GGATAATAACCTGTGCAGGAGTGATAATAA|GCCGACCCTTGGTGGTGACCTGGCCGTAAG
ACCCCAATGTGCAGGAGTCAACCCCAATAA|GACGGCTATGCGGAGGTACTAAAGGTATGC
CCCAGAATCCGCATATATACAGCCATTTCG|ATCGAGATAATAACCTGTGCAGGAGTCAAC
AGTGAATAAAAGAGATAATAACCGATAATA|GAGTGATAATAACCTGTGCAGGAGTCAACC
TACGACGGCTATGCGGAGGTACTAAAGGTA|CCAAGACTTCACGCGCGATAATAACCTGTG
CATCGAGATAATAACCTGTGCAGGAGTCAA|TAACGGCGCAATGTCGCCTCTTGTACCTCC
CCAAGACTTCACGCGCGATAATAACCTGTG|TAGTGTCTGCGACGCTACAGTGAGCCTACA
GACGCTACAGTGAGCCTACATCGGAAAATC|GATGCCATCACATTTGGGGAGGTGTCCGGC
TAACCTGTGCAGGAGTCAACCCCAAAGTGA|ACCACGCGGATAATAACCTGTGCAGGAGTG
GCTACCGAGTAGCTCTATCTTAGTTTTTTG|CTGGCAAGACGCATGTACCTAATCATACAG
ATAATAACCTGTGCAGGAGTCAACCCCAAA|GCCAACCACGCGGATAATAACCTGTGCAGG
ACATCGAGATAATAACCTGTGCAGGAGTCA|ATAACGGCGCAATGTCGCCTCTTGTACCTC
TAACCTGTGCAGGAGTGATAATAACCTGTG|CCTTGGTGGTGACCTGGCCGTAAGTATCCG
CTGTGCAGGAGTCAACCCCAAAGTGAATAA|CGCGGATAATAACCTGTGCAGGAGTGATAA
CCTGTGCAGGAGTCAACCCCAATTTCGAAC|CCTACATCGGAAAATCGTTGGTCCTGAACT
GATAATAACCTGTGCAGGAGTCAACCCCAA|AGCCAACCACGCGGATAATAACCTGTGCAG
ACCTATTCACGTCGTAATACCGCTACAACT|GAGCGGACACAGAAAAAGATCTGACGTTGG
GGCTATGCGGAGGTACTAAAGGTATGCCGC|CTTCACGCGCGATAATAACCTGTGCAGGAG
TGTGCAGGAGTCAACCCCAATAAAAAATCT|CAAGAGAGTGGGGTTTGCGTAACCCCACGG
GGTGACCTGGCCGTAAGTATCCGATAATAA|ACCTGTGCAGGAGTCAACCCCAATAAAAAA
GCGCAGAAGGGAACGGTTTATGAGACGATG|CACGAAAACCGTGATAATAACCTGTGCAGG
TCAACCCCAACAACCCCAACTGTTATTACA|AGACAGGCATTTACGCCGGAGAAGAAAGTC
TCAACCCCAAGACTTCACGCGCGATAATAA|GATACCTAGTGTCTGCGACGCTACAGTGAG
CGGTTTATGAGACGATGCTTGCGGGGCACC|ATAATAACCTGTGCAGGAGTCAACCCCAAA
GGCGCCTGGTCCCCAACTCGCTATCCCAGA|CCCCAACGGATTGGGTTTCTGTACATCGAG
CGATGCTTGCGGGGCACCCGATGATAACGG|GCAGGAGTCAACCCCAAAGTGAATAAAAGA
TGCAGGAGTGATAATAACCTGTGCAGGAGT|AGAATCCGCATATATACAGCCATTTCGGAA
ACCCCAAGCCAACCACGCGGATAATAACCT|CTGGTCACACGGTGATGAGCCGACCCTTGG
GTAAGTATCCGATAATAACCTGTGCAGGAG|GTCAACCCCAATAAAAAATCTAGGCAACTA
CGCTATCCCAGAATCCGCATATATACAGCC|CTGTACATCGAGATAATAACCTGTGCAGGA
GAACTGCGCGATAATAACCTGTGCAGGAGT|CGAGCCGTATCAGACTTGGCACCCTGAATT
CCCAACGGATTGGGTTTCTGTACATCGAGA|ATGCTTGCGGGGCACCCGATGATAACGGCG
TACATCGAGATAATAACCTGTGCAGGAGTC|GATAACGGCGCAATGTCGCCTCTTGTACCT
AGCTCTATCTTAGTTTTTTGATAATAACCT|GCATGTACCTAATCATACAGCAGTGACCGA
CCAAGCCAACCACGCGGATAATAACCTGTG|GTCACACGGTGATGAGCCGACCCTTGGTGG
TATTACAGCGGTACGATACAGAAGCTCGTT|GAAAGTCGAACGAAGCTGTCGCATTTTGAT
AGTGATAATAACCTGTGCAGGAGTCAACCC|CTGGCCGTAAGTATCCGATAATAACCTGTG
TTTTCTGTGCCCGAAACCGGTGATGGTCCC|TCAACCCCAATGTGCAGGAGTCAACCCCAA
CGGATTGGGTTTCTGTACATCGAGATAATA|TGCGGGGCACCCGATGATAACGGCGCAATG
AGACTTCACGCGCGATAATAACCTGTGCAG|TGTCTGCGACGCTACAGTGAGCCTACATCG
CCAACTCGCTATCCCAGAATCCGCATATAT|GGGTTTCTGTACATCGAGATAATAACCTGT
TAGATGGTCGTTCGATGAAGTGCGCGGCGG|ATGCCGAATGCCTATTGGCGCCTGGTCCCC
AACCTGTGCAGGAGTCAACCCCAACCTATT|ACCGAAGCGGTTTCTGCCTCAACGAGCGGA
GTATGCCGCTCTAACTAATTTATACTGGTC|GTGCAGGAGTCAACCCCAATTTCGAACTAA
AAAAAATCTAGGCAACTAGATACCTAGTGT|ACCCCACGGCCAGCTGTCTTACCGGACTAG
GTGCAGGAGTCAACCCCAATAAAAAATCTA|AAGAGAGTGGGGTTTGCGTAACCCCACGGC
CGATACAGAAGCTCGTTACCCCATGCCGAA|AGCTGTCGCATTTTGATAATAACCTGTGCA
CGGAATTCAAATGCGCAGAAGGGAACGGTT|TCATAGTAACTGCACGAAAACCGTGATAAT
AGGAGTCAACCCCAAGACTTCACGCGCGAT|AACTAGATACCTAGTGTCTGCGACGCTACA
CGCTACAGTGAGCCTACATCGGAAAATCGT|TGCCATCACATTTGGGGAGGTGTCCGGCAA
AGAAAGTCGAACGAAGCTGTCGCATTTTGA|GAGATAATTTCGGGCGGAATTCAAATGCGC
GAGGTACTAAAGGTATGCCGCTCTAACTAA|CGATAATAACCTGTGCAGGAGTCAACCCCA
AATGTCGCCTCTTGTACCTCCAACGGCTTT|AATAACCGATAATAACCTGTGCAGGAGTCA
GGAATTCAAATGCGCAGAAGGGAACGGTTT|CATAGTAACTGCACGAAAACCGTGATAATA
CCCAATACGACGGCTATGCGGAGGTACTAA|CAACCCCAAGACTTCACGCGCGATAATAAC
AACTCGCTATCCCAGAATCCGCATATATAC|GTTTCTGTACATCGAGATAATAACCTGTGC
CTAGTTTCGATGCCATCACATTTGGGGAGG|ATAATAACCTGTGCAGGAGTCAACCCCAAC
GTAAACAATCCCGACGATAATAACCTGTGC|TAATAACCTGTGCAGGAGTCAACCCCAAGA
GGTGGTGACCTGGCCGTAAGTATCCGATAA|ATAACCTGTGCAGGAGTCAACCCCAATAAA
ATAAAAGAGATAATAACCGATAATAACCTG|ATAATAACCTGTGCAGGAGTCAACCCCAAC
GCAGGAGTCAACCCCAACAACCCCAACTGT|TTTCGGAAGACAGGCATTTACGCCGGAGAA
ACAATCCCGACGATAATAACCTGTGCAGGA|AACCTGTGCAGGAGTCAACCCCAAGAGAGT
AGAAGAAAGTCGAACGAAGCTGTCGCATTT|TTTGAGATAATTTCGGGCGGAATTCAAATG
GAGTCAACCCCAATAAAAAATCTAGGCAAC|GTGGGGTTTGCGTAACCCCACGGCCAGCTG
CCTCTTGTACCTCCAACGGCTTTTCTGTGC|GATAATAACCTGTGCAGGAGTCAACCCCAA
AGACGATGCTTGCGGGGCACCCGATGATAA|TGTGCAGGAGTCAACCCCAAAGTGAATAAA
ACCTGTGCAGGAGTCAACCCCAAGACTTCA|ATCTAGGCAACTAGATACCTAGTGTCTGCG
AACGTGTCACCTCGTAGCTACCGAGTAGCT|TCTATGGTACTTAGTACTGGCAAGACGCAT
AAGGGAACGGTTTATGAGACGATGCTTGCG|AACCGTGATAATAACCTGTGCAGGAGTCAA
CATTTCGGAAGACAGGCATTTACGCCGGAG|AGTCAACCCCAAACGCATCTTGTGTCCGTT
CCCCAAACGCATCTTGTGTCCGTTTGAGAT|AACGGCTTTTCTGTGCCCGAAACCGGTGAT
GCGATAATAACCTGTGCAGGAGTGATAATA|CAACTCGCTATCCCAGAATCCGCATATATA
ACCCCAAGACTTCACGCGCGATAATAACCT|ACCTAGTGTCTGCGACGCTACAGTGAGCCT
CACGAGCCGTATCAGACTTGGCACCCTGAA|TACCGCTACAACTTGCTGAGTGGCTTTCCA
ATGATAACGGCGCAATGTCGCCTCTTGTAC|GAATAAAAGAGATAATAACCGATAATAACC
CCGGACTAGTTTCGATGCCATCACATTTGG|TTTTGATAATAACCTGTGCAGGAGTCAACC
TCAACCCCAACGGATTGGGTTTCTGTACAT|AGACGATGCTTGCGGGGCACCCGATGATAA
CTGTCGCATTTTGATAATAACCTGTGCAGG|GAATTCAAATGCGCAGAAGGGAACGGTTTA
ACTAAAGGTATGCCGCTCTAACTAATTTAT|ATAACCTGTGCAGGAGTCAACCCCAATTTC
TAATAACCTGTGCAGGAGTGATAATAACCT|TCGCTATCCCAGAATCCGCATATATACAGC
CGGCAACTCCGCACGAGCCGTATCAGACTT|TCACGTCGTAATACCGCTACAACTTGCTGA
CGTATCAGACTTGGCACCCTGAATTGTTCA|ACAACTTGCTGAGTGGCTTTCCACCGTGTT
GTTTCGATGCCATCACATTTGGGGAGGTGT|ATAACCTGTGCAGGAGTCAACCCCAACCTA
GCCTATTGGCGCCTGGTCCCCAACTCGCTA|GAGTCAACCCCAACGGATTGGGTTTCTGTA
ATCAGACTTGGCACCCTGAATTGTTCAGAA|ACTTGCTGAGTGGCTTTCCACCGTGTTCTT
GCTACAGTGAGCCTACATCGGAAAATCGTT|GCCATCACATTTGGGGAGGTGTCCGGCAAC
ATAACCTGTGCAGGAGTCAACCCCAACGGA|AAGGGAACGGTTTATGAGACGATGCTTGCG
ATGAGACGATGCTTGCGGGGCACCCGATGA|ACCTGTGCAGGAGTCAACCCCAAAGTGAAT
GAGCCGTATCAGACTTGGCACCCTGAATTG|CGCTACAACTTGCTGAGTGGCTTTCCACCG
TTCGAACTAAGTAGTAAACAATCCCGACGA|CTGAACTGCGCGATAATAACCTGTGCAGGA
CGGAGGTACTAAAGGTATGCCGCTCTAACT|CGCGATAATAACCTGTGCAGGAGTCAACCC
CGTTGGTCCTGAACTGCGCGATAATAACCT|CAACTCCGCACGAGCCGTATCAGACTTGGC
AATAACCTGTGCAGGAGTCAACCCCAAAGT|CAACCACGCGGATAATAACCTGTGCAGGAG
ACCTGTGCAGGAGTCAACCCCAATAAAAAA|CCCCAAGAGAGTGGGGTTTGCGTAACCCCA
TACAGTGAGCCTACATCGGAAAATCGTTGG|CATCACATTTGGGGAGGTGTCCGGCAACTC
AGTGAGCCTACATCGGAAAATCGTTGGTCC|CACATTTGGGGAGGTGTCCGGCAACTCCGC
GCAGGAGTCAACCCCAATTTCGAACTAAGT|ATCGGAAAATCGTTGGTCCTGAACTGCGCG
CCCCAACGGATTGGGTTTCTGTACATCGAG|GATGCTTGCGGGGCACCCGATGATAACGGC
CTGTGCAGGAGTCAACCCCAATAAAAAATC|CCAAGAGAGTGGGGTTTGCGTAACCCCACG
GGCAACTCCGCACGAGCCGTATCAGACTTG|CACGTCGTAATACCGCTACAACTTGCTGAG
GTCAACCCCAATAAAAAATCTAGGCAACTA|GGGGTTTGCGTAACCCCACGGCCAGCTGTC
CGGGGCACCCGATGATAACGGCGCAATGTC|AACCCCAAAGTGAATAAAAGAGATAATAAC
CACGGTGATGAGCCGACCCTTGGTGGTGAC|TAGTAAACAATCCCGACGATAATAACCTGT
AACCGATAATAACCTGTGCAGGAGTCAACC|AGGAGTCAACCCCAACAACCCCAATACGAC
TGGTCCCCAACTCGCTATCCCAGAATCCGC|CGGATTGGGTTTCTGTACATCGAGATAATA
TGAAGTGCGCGGCGGCGATAATAACCTGTG|TGGCGCCTGGTCCCCAACTCGCTATCCCAG
GCCTGGTCCCCAACTCGCTATCCCAGAATC|CAACGGATTGGGTTTCTGTACATCGAGATA
TTCAAATGCGCAGAAGGGAACGGTTTATGA|GTAACTGCACGAAAACCGTGATAATAACCT
AACCTGTGCAGGAGTCAACCCCAAGCCAAC|GCTCTAACTAATTTATACTGGTCACACGGT
TAAAGGTATGCCGCTCTAACTAATTTATAC|AACCTGTGCAGGAGTCAACCCCAATTTCGA
ATGCGCAGAAGGGAACGGTTTATGAGACGA|TGCACGAAAACCGTGATAATAACCTGTGCA
CGTTCGATGAAGTGCGCGGCGGCGATAATA|TGCCTATTGGCGCCTGGTCCCCAACTCGCT
GTTATTACAGCGGTACGATACAGAAGCTCG|AAGAAAGTCGAACGAAGCTGTCGCATTTTG
CGTGTCACCTCGTAGCTACCGAGTAGCTCT|TATGGTACTTAGTACTGGCAAGACGCATGT
ACTAGATACCTAGTGTCTGCGACGCTACAG|TGTCTTACCGGACTAGTTTCGATGCCATCA
CCTGTGCAGGAGTCAACCCCAACAACCCCA|AGCCATTTCGGAAGACAGGCATTTACGCCG
ATAATAACCTGTGCAGGAGTCAACCCCAAC|CCGTAAGTATCCGATAATAACCTGTGCAGG
CCAATAAAAAATCTAGGCAACTAGATACCT|GCGTAACCCCACGGCCAGCTGTCTTACCGG
CCCAATTTCGAACTAAGTAGTAAACAATCC|TTGGTCCTGAACTGCGCGATAATAACCTGT
AATAAAAAATCTAGGCAACTAGATACCTAG|GTAACCCCACGGCCAGCTGTCTTACCGGAC
TTTACGCCGGAGAAGAAAGTCGAACGAAGC|CTTGTGTCCGTTTGAGATAATTTCGGGCGG
GAGACGATGCTTGCGGGGCACCCGATGATA|CTGTGCAGGAGTCAACCCCAAAGTGAATAA
GTCAACCCCAAGACTTCACGCGCGATAATA|AGATACCTAGTGTCTGCGACGCTACAGTGA
TACGATACAGAAGCTCGTTACCCCATGCCG|GAAGCTGTCGCATTTTGATAATAACCTGTG
CCGATAATAACCTGTGCAGGAGTCAACCCC|GAGTCAACCCCAACAACCCCAATACGACGG
GTACTAAAGGTATGCCGCTCTAACTAATTT|TAATAACCTGTGCAGGAGTCAACCCCAATT
GTTCAGAAACGTGTCACCTCGTAGCTACCG|GTGTTCTTCTATGGTACTTAGTACTGGCAA
ACGTCGTAATACCGCTACAACTTGCTGAGT|ACAGAAAAAGATCTGACGTTGGCGCTTACA
AGTCAACCCCAAGAGAGTGGGGTTTGCGTA|ATTGTTCAGAAACGTGTCACCTCGTAGCTA
GCTATGCGGAGGTACTAAAGGTATGCCGCT|TTCACGCGCGATAATAACCTGTGCAGGAGT
CAACCCCAACAACCCCAATACGACGGCTAT|CCTGTGCAGGAGTCAACCCCAAGACTTCAC
AGTCAACCCCAAGCCAACCACGCGGATAAT|TTATACTGGTCACACGGTGATGAGCCGACC
TCAACCCCAAGAGAGTGGGGTTTGCGTAAC|TGTTCAGAAACGTGTCACCTCGTAGCTACC
CAGGAGTCAACCCCAATTTCGAACTAAGTA|TCGGAAAATCGTTGGTCCTGAACTGCGCGA
TTACCGGACTAGTTTCGATGCCATCACATT|GTTTTTTGATAATAACCTGTGCAGGAGTCA
TCAACCCCAACAACCCCAATACGACGGCTA|ACCTGTGCAGGAGTCAACCCCAAGACTTCA
TAGCTCTATCTTAGTTTTTTGATAATAACC|CGCATGTACCTAATCATACAGCAGTGACCG
GTCACACGGTGATGAGCCGACCCTTGGTGG|TAAGTAGTAAACAATCCCGACGATAATAAC
GCTCTATCTTAGTTTTTTGATAATAACCTG|CATGTACCTAATCATACAGCAGTGACCGAA
CGGAAAATCGTTGGTCCTGAACTGCGCGAT|GTGTCCGGCAACTCCGCACGAGCCGTATCA
ACAACCCCAATACGACGGCTATGCGGAGGT|GGAGTCAACCCCAAGACTTCACGCGCGATA
ATCTTAGTTTTTTGATAATAACCTGTGCAG|ACCTAATCATACAGCAGTGACCGAAGCGGT
GGGGTTTGCGTAACCCCACGGCCAGCTGTC|ACCTCGTAGCTACCGAGTAGCTCTATCTTA
ATAATAACCTGTGCAGGAGTCAACCCCAAG|ATGCCGCTCTAACTAATTTATACTGGTCAC
CGGTACGATACAGAAGCTCGTTACCCCATG|AACGAAGCTGTCGCATTTTGATAATAACCT
ATAATAACCTGTGCAGGAGTCAACCCCAAA|GCAATGTCGCCTCTTGTACCTCCAACGGCT
AGTCAACCCCAACAACCCCAATACGACGGC|TAACCTGTGCAGGAGTCAACCCCAAGACTT
AACAATCCCGACGATAATAACCTGTGCAGG|TAACCTGTGCAGGAGTCAACCCCAAGAGAG
GGAGAAGAAAGTCGAACGAAGCTGTCGCAT|CGTTTGAGATAATTTCGGGCGGAATTCAAA
ACGGCGCAATGTCGCCTCTTGTACCTCCAA|AAGAGATAATAACCGATAATAACCTGTGCA
CCAACCTATTCACGTCGTAATACCGCTACA|AACGAGCGGACACAGAAAAAGATCTGACGT
ATTGTTCAGAAACGTGTCACCTCGTAGCTA|ACCGTGTTCTTCTATGGTACTTAGTACTGG
CCACGGCCAGCTGTCTTACCGGACTAGTTT|AGTAGCTCTATCTTAGTTTTTTGATAATAA
GGAGTCAACCCCAAGAGAGTGGGGTTTGCG|GAATTGTTCAGAAACGTGTCACCTCGTAGC
GTGCAGGAGTCAACCCCAACCTATTCACGT|AGCGGTTTCTGCCTCAACGAGCGGACACAG
ACGATACAGAAGCTCGTTACCCCATGCCGA|AAGCTGTCGCATTTTGATAATAACCTGTGC
GAGAAGAAAGTCGAACGAAGCTGTCGCATT|GTTTGAGATAATTTCGGGCGGAATTCAAAT
GAGTCAACCCCAACCTATTCACGTCGTAAT|TTCTGCCTCAACGAGCGGACACAGAAAAAG
TTTCGAACTAAGTAGTAAACAATCCCGACG|CCTGAACTGCGCGATAATAACCTGTGCAGG
CACCTCGTAGCTACCGAGTAGCTCTATCTT|TACTTAGTACTGGCAAGACGCATGTACCTA
AACCTGTGCAGGAGTCAACCCCAACAACCC|ACAGCCATTTCGGAAGACAGGCATTTACGC
GTTTCTGTACATCGAGATAATAACCTGTGC|ACCCGATGATAACGGCGCAATGTCGCCTCT
AACTCCGCACGAGCCGTATCAGACTTGGCA|GTCGTAATACCGCTACAACTTGCTGAGTGG
TGTGCAGGAGTCAACCCCAAGACTTCACGC|TAGGCAACTAGATACCTAGTGTCTGCGACG
GAATCATAGTAACTGCACGAAAACCGTGAT|TAATAACCTGTGCAGGAGTCAACCCCAAGC
AGCCATTTCGGAAGACAGGCATTTACGCCG|AGGAGTCAACCCCAAACGCATCTTGTGTCC
CCAACAACCCCAATACGACGGCTATGCGGA|GCAGGAGTCAACCCCAAGACTTCACGCGCG
GTGATGAGCCGACCCTTGGTGGTGACCTGG|AAACAATCCCGACGATAATAACCTGTGCAG
CCCAACTCGCTATCCCAGAATCCGCATATA|TGGGTTTCTGTACATCGAGATAATAACCTG
CAAACGCATCTTGTGTCCGTTTGAGATAAT|GGCTTTTCTGTGCCCGAAACCGGTGATGGT
ACGAAGCTGTCGCATTTTGATAATAACCTG|CGGGCGGAATTCAAATGCGCAGAAGGGAAC
CCGAATCATAGTAACTGCACGAAAACCGTG|AATAATAACCTGTGCAGGAGTCAACCCCAA
TATGAGACGATGCTTGCGGGGCACCCGATG|AACCTGTGCAGGAGTCAACCCCAAAGTGAA
ACGTGTCACCTCGTAGCTACCGAGTAGCTC|CTATGGTACTTAGTACTGGCAAGACGCATG
CAACCCCAAAGTGAATAAAAGAGATAATAA|CCTGTGCAGGAGTGATAATAACCTGTGCAG
ATAACCTGTGCAGGAGTCAACCCCAATAAA|CAACCCCAAGAGAGTGGGGTTTGCGTAACC
GGTGTCCGGCAACTCCGCACGAGCCGTATC|ACCTATTCACGTCGTAATACCGCTACAACT
CCGCACGAGCCGTATCAGACTTGGCACCCT|TAATACCGCTACAACTTGCTGAGTGGCTTT
CAACCCCAAGCCAACCACGCGGATAATAAC|TACTGGTCACACGGTGATGAGCCGACCCTT
TGGCCGTAAGTATCCGATAATAACCTGTGC|CAGGAGTCAACCCCAATAAAAAATCTAGGC
TGCAGGAGTCAACCCCAAGCCAACCACGCG|ACTAATTTATACTGGTCACACGGTGATGAG
GATAATAACCTGTGCAGGAGTCAACCCCAA|GCAGTGACCGAAGCGGTTTCTGCCTCAACG
TGGCACCCTGAATTGTTCAGAAACGTGTCA|AGTGGCTTTCCACCGTGTTCTTCTATGGTA
TACATCGGAAAATCGTTGGTCCTGAACTGC|GGGAGGTGTCCGGCAACTCCGCACGAGCCG
GATAATAACCTGTGCAGGAGTCAACCCCAA|ACAGTGAGCCTACATCGGAAAATCGTTGGT
TATACTGGTCACACGGTGATGAGCCGACCC|TTCGAACTAAGTAGTAAACAATCCCGACGA
GAAAGTCGAACGAAGCTGTCGCATTTTGAT|AGATAATTTCGGGCGGAATTCAAATGCGCA
CAACCACGCGGATAATAACCTGTGCAGGAG|CGGTGATGAGCCGACCCTTGGTGGTGACCT
ACCTCGTAGCTACCGAGTAGCTCTATCTTA|ACTTAGTACTGGCAAGACGCATGTACCTAA
ACGCGGATAATAACCTGTGCAGGAGTGATA|ATGAGCCGACCCTTGGTGGTGACCTGGCCG
ACGACGGCTATGCGGAGGTACTAAAGGTAT|CAAGACTTCACGCGCGATAATAACCTGTGC
GATAATAACCTGTGCAGGAGTCAACCCCAA|GCAGAAGGGAACGGTTTATGAGACGATGCT
GTCAACCCCAAACGCATCTTGTGTCCGTTT|CCTCCAACGGCTTTTCTGTGCCCGAAACCG
ATGAAGTGCGCGGCGGCGATAATAACCTGT|TTGGCGCCTGGTCCCCAACTCGCTATCCCA
TCGATGCCATCACATTTGGGGAGGTGTCCG|ACCTGTGCAGGAGTCAACCCCAACCTATTC
CCCGAATCATAGTAACTGCACGAAAACCGT|CAATAATAACCTGTGCAGGAGTCAACCCCA
CCTAGTGTCTGCGACGCTACAGTGAGCCTA|CGGACTAGTTTCGATGCCATCACATTTGGG
GGGGCACCCGATGATAACGGCGCAATGTCG|ACCCCAAAGTGAATAAAAGAGATAATAACC
AATAACCTGTGCAGGAGTGATAATAACCTG|CGCTATCCCAGAATCCGCATATATACAGCC
AGCGGTACGATACAGAAGCTCGTTACCCCA|CGAACGAAGCTGTCGCATTTTGATAATAAC
GTCGCATTTTGATAATAACCTGTGCAGGAG|ATTCAAATGCGCAGAAGGGAACGGTTTATG
CCGTATCAGACTTGGCACCCTGAATTGTTC|TACAACTTGCTGAGTGGCTTTCCACCGTGT
AGGTGTCCGGCAACTCCGCACGAGCCGTAT|AACCTATTCACGTCGTAATACCGCTACAAC
ATTTCGAACTAAGTAGTAAACAATCCCGAC|TCCTGAACTGCGCGATAATAACCTGTGCAG
AGACAGGCATTTACGCCGGAGAAGAAAGTC|CAAACGCATCTTGTGTCCGTTTGAGATAAT
TAGGCAACTAGATACCTAGTGTCTGCGACG|GCCAGCTGTCTTACCGGACTAGTTTCGATG
AATACGACGGCTATGCGGAGGTACTAAAGG|CCCCAAGACTTCACGCGCGATAATAACCTG
ATATATACAGCCATTTCGGAAGACAGGCAT|ACCTGTGCAGGAGTCAACCCCAAACGCATC
TCGTTCGATGAAGTGCGCGGCGGCGATAAT|ATGCCTATTGGCGCCTGGTCCCCAACTCGC
CAGAAGCTCGTTACCCCATGCCGAATGCCT|TCGCATTTTGATAATAACCTGTGCAGGAGT
GATAATAACCTGTGCAGGAGTGATAATAAC|CCGACCCTTGGTGGTGACCTGGCCGTAAGT
TAATAACCTGTGCAGGAGTCAACCCCAACC|AGTGACCGAAGCGGTTTCTGCCTCAACGAG
GTGCGCGGCGGCGATAATAACCTGTGCAGG|GCCTGGTCCCCAACTCGCTATCCCAGAATC
CCTGTGCAGGAGTCAACCCCAACAACCCCA|TATCCGATAATAACCTGTGCAGGAGTCAAC
TTTCGGGCGGAATTCAAATGCGCAGAAGGG|TCCCGAATCATAGTAACTGCACGAAAACCG
TTTCTGTGCCCGAAACCGGTGATGGTCCCG|CAACCCCAATGTGCAGGAGTCAACCCCAAT
TAACCTGTGCAGGAGTCAACCCCAAACGCA|TGTCGCCTCTTGTACCTCCAACGGCTTTTC
GTCCCGAATCATAGTAACTGCACGAAAACC|CCCAATAATAACCTGTGCAGGAGTCAACCC
TCACCTCGTAGCTACCGAGTAGCTCTATCT|GTACTTAGTACTGGCAAGACGCATGTACCT
GAGTCAACCCCAATTTCGAACTAAGTAGTA|GAAAATCGTTGGTCCTGAACTGCGCGATAA
GCATTTTGATAATAACCTGTGCAGGAGTCA|CAAATGCGCAGAAGGGAACGGTTTATGAGA
AACCCCAACTGTTATTACAGCGGTACGATA|TACGCCGGAGAAGAAAGTCGAACGAAGCTG
GGAGTAGATGGTCGTTCGATGAAGTGCGCG|CCCCATGCCGAATGCCTATTGGCGCCTGGT
CAACAACCCCAACTGTTATTACAGCGGTAC|CATTTACGCCGGAGAAGAAAGTCGAACGAA
CGCACGAGCCGTATCAGACTTGGCACCCTG|AATACCGCTACAACTTGCTGAGTGGCTTTC
TCTGTACATCGAGATAATAACCTGTGCAGG|CGATGATAACGGCGCAATGTCGCCTCTTGT
CCCAATGTGCAGGAGTCAACCCCAATAATA|CGGCTATGCGGAGGTACTAAAGGTATGCCG
GACAGGCATTTACGCCGGAGAAGAAAGTCG|AAACGCATCTTGTGTCCGTTTGAGATAATT
CAGCCATTTCGGAAGACAGGCATTTACGCC|CAGGAGTCAACCCCAAACGCATCTTGTGTC
CCCAACAACCCCAATACGACGGCTATGCGG|TGCAGGAGTCAACCCCAAGACTTCACGCGC
TTCAGAAACGTGTCACCTCGTAGCTACCGA|TGTTCTTCTATGGTACTTAGTACTGGCAAG
AAAGTCGAACGAAGCTGTCGCATTTTGATA|GATAATTTCGGGCGGAATTCAAATGCGCAG
AACCCCAATAATAACCTGTGCAGGAGTCAA|TAAAGGTATGCCGCTCTAACTAATTTATAC
GTCAACCCCAATTTCGAACTAAGTAGTAAA|AAATCGTTGGTCCTGAACTGCGCGATAATA
TTCGATGAAGTGCGCGGCGGCGATAATAAC|CCTATTGGCGCCTGGTCCCCAACTCGCTAT
TTACGCCGGAGAAGAAAGTCGAACGAAGCT|TTGTGTCCGTTTGAGATAATTTCGGGCGGA
CCAAGAGAGTGGGGTTTGCGTAACCCCACG|GAAACGTGTCACCTCGTAGCTACCGAGTAG
CCGACCCTTGGTGGTGACCTGGCCGTAAGT|CCGACGATAATAACCTGTGCAGGAGTCAAC
TCAACCCCAATTTCGAACTAAGTAGTAAAC|AATCGTTGGTCCTGAACTGCGCGATAATAA
GATGCCATCACATTTGGGGAGGTGTCCGGC|CTGTGCAGGAGTCAACCCCAACCTATTCAC
CAACCCCAACGGATTGGGTTTCTGTACATC|GACGATGCTTGCGGGGCACCCGATGATAAC
ACTGCACGAAAACCGTGATAATAACCTGTG|GCAGGAGTCAACCCCAAGCCAACCACGCGG
GCTTGCGGGGCACCCGATGATAACGGCGCA|GAGTCAACCCCAAAGTGAATAAAAGAGATA
GCATATATACAGCCATTTCGGAAGACAGGC|TAACCTGTGCAGGAGTCAACCCCAAACGCA
ACTGGTCACACGGTGATGAGCCGACCCTTG|GAACTAAGTAGTAAACAATCCCGACGATAA
AGGAGTCAACCCCAAACGCATCTTGTGTCC|TGTACCTCCAACGGCTTTTCTGTGCCCGAA
GTAGATGGTCGTTCGATGAAGTGCGCGGCG|CATGCCGAATGCCTATTGGCGCCTGGTCCC
AGGAGTCAACCCCAACGGATTGGGTTTCTG|TTATGAGACGATGCTTGCGGGGCACCCGAT
AACCTATTCACGTCGTAATACCGCTACAAC|CGAGCGGACACAGAAAAAGATCTGACGTTG
TAACCCCACGGCCAGCTGTCTTACCGGACT|TACCGAGTAGCTCTATCTTAGTTTTTTGAT
AAGCTGTCGCATTTTGATAATAACCTGTGC|GCGGAATTCAAATGCGCAGAAGGGAACGGT
CGGCGCAATGTCGCCTCTTGTACCTCCAAC|AGAGATAATAACCGATAATAACCTGTGCAG
ATAACCTGTGCAGGAGTCAACCCCAATGTG|ACCCCAACAACCCCAATACGACGGCTATGC
AGGAGTCAACCCCAATAATAACCTGTGCAG|GAGGTACTAAAGGTATGCCGCTCTAACTAA
CTGCACGAAAACCGTGATAATAACCTGTGC|CAGGAGTCAACCCCAAGCCAACCACGCGGA
TGGGTTTCTGTACATCGAGATAATAACCTG|GGCACCCGATGATAACGGCGCAATGTCGCC
AACGGCTTTTCTGTGCCCGAAACCGGTGAT|CAGGAGTCAACCCCAATGTGCAGGAGTCAA
GTGTCCGGCAACTCCGCACGAGCCGTATCA|CCTATTCACGTCGTAATACCGCTACAACTT
TGCCCGAAACCGGTGATGGTCCCGAATCAT|CAATGTGCAGGAGTCAACCCCAATAATAAC
CGCAATGTCGCCTCTTGTACCTCCAACGGC|GATAATAACCGATAATAACCTGTGCAGGAG
TGCGGGGCACCCGATGATAACGGCGCAATG|TCAACCCCAAAGTGAATAAAAGAGATAATA
GAGTCAACCCCAACAACCCCAACTGTTATT|GGAAGACAGGCATTTACGCCGGAGAAGAAA
CTGGTCACACGGTGATGAGCCGACCCTTGG|AACTAAGTAGTAAACAATCCCGACGATAAT
ACCTGTGCAGGAGTCAACCCCAAGCCAACC|CTCTAACTAATTTATACTGGTCACACGGTG
CGGGCGGAATTCAAATGCGCAGAAGGGAAC|CGAATCATAGTAACTGCACGAAAACCGTGA
CCTACATCGGAAAATCGTTGGTCCTGAACT|TGGGGAGGTGTCCGGCAACTCCGCACGAGC
CGTGATAATAACCTGTGCAGGAGTCAACCC|CCAAGCCAACCACGCGGATAATAACCTGTG
GCACCCTGAATTGTTCAGAAACGTGTCACC|TGGCTTTCCACCGTGTTCTTCTATGGTACT
AATAACCTGTGCAGGAGTCAACCCCAAGAC|AAAAATCTAGGCAACTAGATACCTAGTGTC
CTTACCGGACTAGTTTCGATGCCATCACAT|AGTTTTTTGATAATAACCTGTGCAGGAGTC
CCGGAGAAGAAAGTCGAACGAAGCTGTCGC|TCCGTTTGAGATAATTTCGGGCGGAATTCA
AATAACCTGTGCAGGAGTCAACCCCAACGG|GAAGGGAACGGTTTATGAGACGATGCTTGC
GCGCGATAATAACCTGTGCAGGAGTCAACC|CGTATCAGACTTGGCACCCTGAATTGTTCA
CCGATGATAACGGCGCAATGTCGCCTCTTG|AGTGAATAAAAGAGATAATAACCGATAATA
TAGTTTTTTGATAATAACCTGTGCAGGAGT|AATCATACAGCAGTGACCGAAGCGGTTTCT
GATAATAACCTGTGCAGGAGTGATAATAAC|ACTCGCTATCCCAGAATCCGCATATATACA
GTCAACCCCAACGGATTGGGTTTCTGTACA|GAGACGATGCTTGCGGGGCACCCGATGATA
CAAGCCAACCACGCGGATAATAACCTGTGC|TCACACGGTGATGAGCCGACCCTTGGTGGT
TGCGGAGGTACTAAAGGTATGCCGCTCTAA|CGCGCGATAATAACCTGTGCAGGAGTCAAC
CCAACCACGCGGATAATAACCTGTGCAGGA|ACGGTGATGAGCCGACCCTTGGTGGTGACC
TCAACCCCAAAGTGAATAAAAGAGATAATA|ACCTGTGCAGGAGTGATAATAACCTGTGCA
AAGAGATAATAACCGATAATAACCTGTGCA|TAACCTGTGCAGGAGTCAACCCCAACAACC
ACCTAGTGTCTGCGACGCTACAGTGAGCCT|CCGGACTAGTTTCGATGCCATCACATTTGG
ACGATAATAACCTGTGCAGGAGTCAACCCC|AGGAGTCAACCCCAAGAGAGTGGGGTTTGC
TCGTTGGTCCTGAACTGCGCGATAATAACC|GCAACTCCGCACGAGCCGTATCAGACTTGG
CCCCACGGCCAGCTGTCTTACCGGACTAGT|CGAGTAGCTCTATCTTAGTTTTTTGATAAT
ATTCAAATGCGCAGAAGGGAACGGTTTATG|AGTAACTGCACGAAAACCGTGATAATAACC
TCTGCGACGCTACAGTGAGCCTACATCGGA|GTTTCGATGCCATCACATTTGGGGAGGTGT
CGGTGATGGTCCCGAATCATAGTAACTGCA|GAGTCAACCCCAATAATAACCTGTGCAGGA
CAGGAGTCAACCCCAATGTGCAGGAGTCAA|CCCCAATACGACGGCTATGCGGAGGTACTA
TGCCATCACATTTGGGGAGGTGTCCGGCAA|GTGCAGGAGTCAACCCCAACCTATTCACGT
TAGCTACCGAGTAGCTCTATCTTAGTTTTT|TACTGGCAAGACGCATGTACCTAATCATAC
GTCCTGAACTGCGCGATAATAACCTGTGCA|CCGCACGAGCCGTATCAGACTTGGCACCCT
ATTACAGCGGTACGATACAGAAGCTCGTTA|AAAGTCGAACGAAGCTGTCGCATTTTGATA
ATAACCTGTGCAGGAGTCAACCCCAAGACT|AAAATCTAGGCAACTAGATACCTAGTGTCT
GCTATCCCAGAATCCGCATATATACAGCCA|TGTACATCGAGATAATAACCTGTGCAGGAG
AACCGTGATAATAACCTGTGCAGGAGTCAA|ACCCCAAGCCAACCACGCGGATAATAACCT
AGCTGTCGCATTTTGATAATAACCTGTGCA|CGGAATTCAAATGCGCAGAAGGGAACGGTT
CCAACAACCCCAACTGTTATTACAGCGGTA|GCATTTACGCCGGAGAAGAAAGTCGAACGA
CTCCAACGGCTTTTCTGTGCCCGAAACCGG|TGTGCAGGAGTCAACCCCAATGTGCAGGAG
AACCCCAAACGCATCTTGTGTCCGTTTGAG|CCAACGGCTTTTCTGTGCCCGAAACCGGTG
ATAACCTGTGCAGGAGTCAACCCCAAGAGA|ACTTGGCACCCTGAATTGTTCAGAAACGTG
GAAGCTCGTTACCCCATGCCGAATGCCTAT|GCATTTTGATAATAACCTGTGCAGGAGTCA
CTACAGTGAGCCTACATCGGAAAATCGTTG|CCATCACATTTGGGGAGGTGTCCGGCAACT
CAAGAGAGTGGGGTTTGCGTAACCCCACGG|AAACGTGTCACCTCGTAGCTACCGAGTAGC
GGAGTCAACCCCAATTTCGAACTAAGTAGT|GGAAAATCGTTGGTCCTGAACTGCGCGATA
TGTGCAGGAGTCAACCCCAATTTCGAACTA|TACATCGGAAAATCGTTGGTCCTGAACTGC
TCCGTTTGAGATAATTTCGGGCGGAATTCA|GAAACCGGTGATGGTCCCGAATCATAGTAA
GGTCCTGAACTGCGCGATAATAACCTGTGC|TCCGCACGAGCCGTATCAGACTTGGCACCC
AATTCAAATGCGCAGAAGGGAACGGTTTAT|TAGTAACTGCACGAAAACCGTGATAATAAC
AACTAAGTAGTAAACAATCCCGACGATAAT|ACTGCGCGATAATAACCTGTGCAGGAGTCA
CCCTTGGTGGTGACCTGGCCGTAAGTATCC|CGATAATAACCTGTGCAGGAGTCAACCCCA
TGTGCAGGAGTCAACCCCAAAGTGAATAAA|GCGGATAATAACCTGTGCAGGAGTGATAAT
AATCGTTGGTCCTGAACTGCGCGATAATAA|CGGCAACTCCGCACGAGCCGTATCAGACTT
CCGATAATAACCTGTGCAGGAGTCAACCCC|CAATAAAAAATCTAGGCAACTAGATACCTA
TCGAACTAAGTAGTAAACAATCCCGACGAT|TGAACTGCGCGATAATAACCTGTGCAGGAG
AATCCGCATATATACAGCCATTTCGGAAGA|GATAATAACCTGTGCAGGAGTCAACCCCAA
AGTTTCGATGCCATCACATTTGGGGAGGTG|AATAACCTGTGCAGGAGTCAACCCCAACCT
GTGCAGGAGTCAACCCCAAAGTGAATAAAA|CGGATAATAACCTGTGCAGGAGTGATAATA
TTTCGGAAGACAGGCATTTACGCCGGAGAA|TCAACCCCAAACGCATCTTGTGTCCGTTTG
GTGATGGTCCCGAATCATAGTAACTGCACG|GTCAACCCCAATAATAACCTGTGCAGGAGT
TTGAGATAATTTCGGGCGGAATTCAAATGC|CGGTGATGGTCCCGAATCATAGTAACTGCA
GCCATCACATTTGGGGAGGTGTCCGGCAAC|TGCAGGAGTCAACCCCAACCTATTCACGTC
CCCGACGATAATAACCTGTGCAGGAGTCAA|GTGCAGGAGTCAACCCCAAGAGAGTGGGGT
CAGGAGTCAACCCCAAGACTTCACGCGCGA|CAACTAGATACCTAGTGTCTGCGACGCTAC
TGATAATAACCTGTGCAGGAGTCAACCCCA|CATATATACAGCCATTTCGGAAGACAGGCA
CGACGATAATAACCTGTGCAGGAGTCAACC|GCAGGAGTCAACCCCAAGAGAGTGGGGTTT
ATCTAGGCAACTAGATACCTAGTGTCTGCG|ACGGCCAGCTGTCTTACCGGACTAGTTTCG
TATCCCAGAATCCGCATATATACAGCCATT|TACATCGAGATAATAACCTGTGCAGGAGTC
CAACGGATTGGGTTTCTGTACATCGAGATA|GCTTGCGGGGCACCCGATGATAACGGCGCA
ACCCCAAACGCATCTTGTGTCCGTTTGAGA|CAACGGCTTTTCTGTGCCCGAAACCGGTGA
CGAGCCGTATCAGACTTGGCACCCTGAATT|CCGCTACAACTTGCTGAGTGGCTTTCCACC
CAGACTTGGCACCCTGAATTGTTCAGAAAC|TTGCTGAGTGGCTTTCCACCGTGTTCTTCT
TGCCGAATGCCTATTGGCGCCTGGTCCCCA|CTGTGCAGGAGTCAACCCCAACGGATTGGG
TAACCTGTGCAGGAGTCAACCCCAACAACC|TACAGCCATTTCGGAAGACAGGCATTTACG
ACGATGCTTGCGGGGCACCCGATGATAACG|TGCAGGAGTCAACCCCAAAGTGAATAAAAG
TCAACCCCAAGCCAACCACGCGGATAATAA|ATACTGGTCACACGGTGATGAGCCGACCCT
AACCTGTGCAGGAGTCAACCCCAAAGTGAA|CCACGCGGATAATAACCTGTGCAGGAGTGA
CTATCTTAGTTTTTTGATAATAACCTGTGC|GTACCTAATCATACAGCAGTGACCGAAGCG
GGCATTTACGCCGGAGAAGAAAGTCGAACG|GCATCTTGTGTCCGTTTGAGATAATTTCGG
GTTTGAGATAATTTCGGGCGGAATTCAAAT|ACCGGTGATGGTCCCGAATCATAGTAACTG
AATAACCTGTGCAGGAGTCAACCCCAATTT|GTGAGCCTACATCGGAAAATCGTTGGTCCT
ACGGTTTATGAGACGATGCTTGCGGGGCAC|GATAATAACCTGTGCAGGAGTCAACCCCAA
ATAATAACCTGTGCAGGAGTCAACCCCAAG|CAGACTTGGCACCCTGAATTGTTCAGAAAC
CGTTTGAGATAATTTCGGGCGGAATTCAAA|AACCGGTGATGGTCCCGAATCATAGTAACT
GGTTTCTGTACATCGAGATAATAACCTGTG|CACCCGATGATAACGGCGCAATGTCGCCTC
TACCTAGTGTCTGCGACGCTACAGTGAGCC|ACCGGACTAGTTTCGATGCCATCACATTTG
ACGGCCAGCTGTCTTACCGGACTAGTTTCG|TAGCTCTATCTTAGTTTTTTGATAATAACC
ACCCCAATAATAACCTGTGCAGGAGTCAAC|AAAGGTATGCCGCTCTAACTAATTTATACT
CCGTGATAATAACCTGTGCAGGAGTCAACC|CCCAAGCCAACCACGCGGATAATAACCTGT
GAGGTGTCCGGCAACTCCGCACGAGCCGTA|CAACCTATTCACGTCGTAATACCGCTACAA
AGCCGTATCAGACTTGGCACCCTGAATTGT|GCTACAACTTGCTGAGTGGCTTTCCACCGT
CTGTCTTACCGGACTAGTTTCGATGCCATC|TCTTAGTTTTTTGATAATAACCTGTGCAGG
TGCAGGAGTGATAATAACCTGTGCAGGAGT|GGTGACCTGGCCGTAAGTATCCGATAATAA
GAGTCAACCCCAACGGATTGGGTTTCTGTA|ATGAGACGATGCTTGCGGGGCACCCGATGA
CCTATTCACGTCGTAATACCGCTACAACTT|AGCGGACACAGAAAAAGATCTGACGTTGGC
TACTAAAGGTATGCCGCTCTAACTAATTTA|AATAACCTGTGCAGGAGTCAACCCCAATTT
TCAACCCCAATAATAACCTGTGCAGGAGTC|ACTAAAGGTATGCCGCTCTAACTAATTTAT
ACCGGACTAGTTTCGATGCCATCACATTTG|TTTTTGATAATAACCTGTGCAGGAGTCAAC
GGTCGTTCGATGAAGTGCGCGGCGGCGATA|GAATGCCTATTGGCGCCTGGTCCCCAACTC
GGCACCCGATGATAACGGCGCAATGTCGCC|CCCAAAGTGAATAAAAGAGATAATAACCGA
CCGACGATAATAACCTGTGCAGGAGTCAAC|TGCAGGAGTCAACCCCAAGAGAGTGGGGTT
CCTATTGGCGCCTGGTCCCCAACTCGCTAT|AGTCAACCCCAACGGATTGGGTTTCTGTAC
GTCGTAATACCGCTACAACTTGCTGAGTGG|AGAAAAAGATCTGACGTTGGCGCTTACAAT
AGTAACTGCACGAAAACCGTGATAATAACC|CTGTGCAGGAGTCAACCCCAAGCCAACCAC
GACTTCACGCGCGATAATAACCTGTGCAGG|GTCTGCGACGCTACAGTGAGCCTACATCGG
CCCAACTGTTATTACAGCGGTACGATACAG|GCCGGAGAAGAAAGTCGAACGAAGCTGTCG
CTGTGCAGGAGTCAACCCCAATTTCGAACT|CTACATCGGAAAATCGTTGGTCCTGAACTG
CAATACGACGGCTATGCGGAGGTACTAAAG|ACCCCAAGACTTCACGCGCGATAATAACCT
AGACTTGGCACCCTGAATTGTTCAGAAACG|TGCTGAGTGGCTTTCCACCGTGTTCTTCTA
CATCTTGTGTCCGTTTGAGATAATTTCGGG|TCTGTGCCCGAAACCGGTGATGGTCCCGAA
TAATAACCTGTGCAGGAGTCAACCCCAAAG|CCAACCACGCGGATAATAACCTGTGCAGGA
CCCATGCCGAATGCCTATTGGCGCCTGGTC|TAACCTGTGCAGGAGTCAACCCCAACGGAT
TGATAATAACCTGTGCAGGAGTCAACCCCA|AAGCCAACCACGCGGATAATAACCTGTGCA
CTCTTGTACCTCCAACGGCTTTTCTGTGCC|ATAATAACCTGTGCAGGAGTCAACCCCAAT
AACCCCAATAAAAAATCTAGGCAACTAGAT|GTTTGCGTAACCCCACGGCCAGCTGTCTTA
CGCAGAAGGGAACGGTTTATGAGACGATGC|ACGAAAACCGTGATAATAACCTGTGCAGGA
AAGTATCCGATAATAACCTGTGCAGGAGTC|CAACCCCAATAAAAAATCTAGGCAACTAGA
CCCCAACAACCCCAACTGTTATTACAGCGG|AGGCATTTACGCCGGAGAAGAAAGTCGAAC
AACCTGTGCAGGAGTCAACCCCAATAAAAA|ACCCCAAGAGAGTGGGGTTTGCGTAACCCC
TGTGCAGGAGTCAACCCCAAGCCAACCACG|TAACTAATTTATACTGGTCACACGGTGATG
ACGCATCTTGTGTCCGTTTGAGATAATTTC|TTTTCTGTGCCCGAAACCGGTGATGGTCCC
GAGTGATAATAACCTGTGCAGGAGTCAACC|CCGCATATATACAGCCATTTCGGAAGACAG
GCAGGAGTCAACCCCAACGGATTGGGTTTC|GTTTATGAGACGATGCTTGCGGGGCACCCG
ACCTGTGCAGGAGTCAACCCCAACAACCCC|GTATCCGATAATAACCTGTGCAGGAGTCAA
TGCAGGAGTCAACCCCAATTTCGAACTAAG|CATCGGAAAATCGTTGGTCCTGAACTGCGC
ATACGACGGCTATGCGGAGGTACTAAAGGT|CCCAAGACTTCACGCGCGATAATAACCTGT
TAGTGTCTGCGACGCTACAGTGAGCCTACA|GACTAGTTTCGATGCCATCACATTTGGGGA
AAGGTATGCCGCTCTAACTAATTTATACTG|CCTGTGCAGGAGTCAACCCCAATTTCGAAC
AACGAAGCTGTCGCATTTTGATAATAACCT|TCGGGCGGAATTCAAATGCGCAGAAGGGAA
GATACAGAAGCTCGTTACCCCATGCCGAAT|GCTGTCGCATTTTGATAATAACCTGTGCAG
CAGGAGTGATAATAACCTGTGCAGGAGTCA|AATCCGCATATATACAGCCATTTCGGAAGA
GAGTCAACCCCAAAGTGAATAAAAGAGATA|ATAACCTGTGCAGGAGTGATAATAACCTGT
GCCAGCTGTCTTACCGGACTAGTTTCGATG|CTCTATCTTAGTTTTTTGATAATAACCTGT
TTTGCGTAACCCCACGGCCAGCTGTCTTAC|CGTAGCTACCGAGTAGCTCTATCTTAGTTT
GTGCAGGAGTCAACCCCAAGAGAGTGGGGT|ACCCTGAATTGTTCAGAAACGTGTCACCTC
CGTAAGTATCCGATAATAACCTGTGCAGGA|AGTCAACCCCAATAAAAAATCTAGGCAACT
CGACCCTTGGTGGTGACCTGGCCGTAAGTA|CGACGATAATAACCTGTGCAGGAGTCAACC
TCTTGTGTCCGTTTGAGATAATTTCGGGCG|TGTGCCCGAAACCGGTGATGGTCCCGAATC
AGCCAACCACGCGGATAATAACCTGTGCAG|ACACGGTGATGAGCCGACCCTTGGTGGTGA
ACGCCGGAGAAGAAAGTCGAACGAAGCTGT|GTGTCCGTTTGAGATAATTTCGGGCGGAAT
TGTCCGGCAACTCCGCACGAGCCGTATCAG|CTATTCACGTCGTAATACCGCTACAACTTG
GGAGTCAACCCCAATAAAAAATCTAGGCAA|AGTGGGGTTTGCGTAACCCCACGGCCAGCT
CACGCGGATAATAACCTGTGCAGGAGTGAT|GATGAGCCGACCCTTGGTGGTGACCTGGCC
TGCAGGAGTCAACCCCAACGGATTGGGTTT|GGTTTATGAGACGATGCTTGCGGGGCACCC
ATTTATACTGGTCACACGGTGATGAGCCGA|AATTTCGAACTAAGTAGTAAACAATCCCGA
GGAAAATCGTTGGTCCTGAACTGCGCGATA|TGTCCGGCAACTCCGCACGAGCCGTATCAG
ACAACCCCAACTGTTATTACAGCGGTACGA|TTTACGCCGGAGAAGAAAGTCGAACGAAGC
TTTGATAATAACCTGTGCAGGAGTCAACCC|ACAGCAGTGACCGAAGCGGTTTCTGCCTCA
TTATACTGGTCACACGGTGATGAGCCGACC|TTTCGAACTAAGTAGTAAACAATCCCGACG
GGAGTCAACCCCAAGCCAACCACGCGGATA|ATTTATACTGGTCACACGGTGATGAGCCGA
GGCAACTAGATACCTAGTGTCTGCGACGCT|CAGCTGTCTTACCGGACTAGTTTCGATGCC
ATCACATTTGGGGAGGTGTCCGGCAACTCC|AGGAGTCAACCCCAACCTATTCACGTCGTA
CTATTCACGTCGTAATACCGCTACAACTTG|GCGGACACAGAAAAAGATCTGACGTTGGCG
TACAGAAGCTCGTTACCCCATGCCGAATGC|TGTCGCATTTTGATAATAACCTGTGCAGGA
CAACCCCAAGAGAGTGGGGTTTGCGTAACC|GTTCAGAAACGTGTCACCTCGTAGCTACCG
TTTTGATAATAACCTGTGCAGGAGTCAACC|ATGCGCAGAAGGGAACGGTTTATGAGACGA
ACCCCAATAAAAAATCTAGGCAACTAGATA|TTTGCGTAACCCCACGGCCAGCTGTCTTAC
TATCTTAGTTTTTTGATAATAACCTGTGCA|TACCTAATCATACAGCAGTGACCGAAGCGG
ACCCCATGCCGAATGCCTATTGGCGCCTGG|AATAACCTGTGCAGGAGTCAACCCCAACGG
CGATAATAACCTGTGCAGGAGTCAACCCCA|GGAGTCAACCCCAAGAGAGTGGGGTTTGCG
CCAACTGTTATTACAGCGGTACGATACAGA|CCGGAGAAGAAAGTCGAACGAAGCTGTCGC
AGATAATAACCTGTGCAGGAGTCAACCCCA|GCGCAATGTCGCCTCTTGTACCTCCAACGG
GGTGATGGTCCCGAATCATAGTAACTGCAC|AGTCAACCCCAATAATAACCTGTGCAGGAG
CCCCAACTGTTATTACAGCGGTACGATACA|CGCCGGAGAAGAAAGTCGAACGAAGCTGTC
GTGCAGGAGTCAACCCCAATAATAACCTGT|TGCGGAGGTACTAAAGGTATGCCGCTCTAA
CGATGAAGTGCGCGGCGGCGATAATAACCT|TATTGGCGCCTGGTCCCCAACTCGCTATCC
TGCAGGAGTCAACCCCAACCTATTCACGTC|GCGGTTTCTGCCTCAACGAGCGGACACAGA
TCTTAGTTTTTTGATAATAACCTGTGCAGG|CCTAATCATACAGCAGTGACCGAAGCGGTT
CGAACTAAGTAGTAAACAATCCCGACGATA|GAACTGCGCGATAATAACCTGTGCAGGAGT
AGCCGACCCTTGGTGGTGACCTGGCCGTAA|TCCCGACGATAATAACCTGTGCAGGAGTCA
TTCTGTGCCCGAAACCGGTGATGGTCCCGA|AACCCCAATGTGCAGGAGTCAACCCCAATA
CATAGTAACTGCACGAAAACCGTGATAATA|AACCTGTGCAGGAGTCAACCCCAAGCCAAC
TTGGTCCTGAACTGCGCGATAATAACCTGT|ACTCCGCACGAGCCGTATCAGACTTGGCAC
CGATAATAACCTGTGCAGGAGTGATAATAA|AACTCGCTATCCCAGAATCCGCATATATAC
GCCTACATCGGAAAATCGTTGGTCCTGAAC|TTGGGGAGGTGTCCGGCAACTCCGCACGAG
TGACCTGGCCGTAAGTATCCGATAATAACC|CTGTGCAGGAGTCAACCCCAATAAAAAATC
ATAATAACCTGTGCAGGAGTGATAATAACC|CTCGCTATCCCAGAATCCGCATATATACAG
ATAACCTGTGCAGGAGTCAACCCCAACAAC|TAAGTATCCGATAATAACCTGTGCAGGAGT
TAGTAACTGCACGAAAACCGTGATAATAAC|CCTGTGCAGGAGTCAACCCCAAGCCAACCA
ATTTTGATAATAACCTGTGCAGGAGTCAAC|AATGCGCAGAAGGGAACGGTTTATGAGACG
CTATTGGCGCCTGGTCCCCAACTCGCTATC|GTCAACCCCAACGGATTGGGTTTCTGTACA
TGTGCAGGAGTGATAATAACCTGTGCAGGA|CCAGAATCCGCATATATACAGCCATTTCGG
CAACCCCAAACGCATCTTGTGTCCGTTTGA|TCCAACGGCTTTTCTGTGCCCGAAACCGGT
TCGCATTTTGATAATAACCTGTGCAGGAGT|TTCAAATGCGCAGAAGGGAACGGTTTATGA
TAACCTGTGCAGGAGTCAACCCCAAGAGAG|CTTGGCACCCTGAATTGTTCAGAAACGTGT
AACCCCAAGCCAACCACGCGGATAATAACC|ACTGGTCACACGGTGATGAGCCGACCCTTG
CAATGTGCAGGAGTCAACCCCAATAATAAC|GCTATGCGGAGGTACTAAAGGTATGCCGCT
ATGGTCGTTCGATGAAGTGCGCGGCGGCGA|CCGAATGCCTATTGGCGCCTGGTCCCCAAC
TAAAAGAGATAATAACCGATAATAACCTGT|TAATAACCTGTGCAGGAGTCAACCCCAACA
TAGTTTCGATGCCATCACATTTGGGGAGGT|TAATAACCTGTGCAGGAGTCAACCCCAACC
TGCAGGAGTCAACCCCAATAAAAAATCTAG|AGAGAGTGGGGTTTGCGTAACCCCACGGCC
TACCGAGTAGCTCTATCTTAGTTTTTTGAT|GGCAAGACGCATGTACCTAATCATACAGCA
TGTCGCATTTTGATAATAACCTGTGCAGGA|AATTCAAATGCGCAGAAGGGAACGGTTTAT
CCCCAACCTATTCACGTCGTAATACCGCTA|TCAACGAGCGGACACAGAAAAAGATCTGAC
GCCAACCACGCGGATAATAACCTGTGCAGG|CACGGTGATGAGCCGACCCTTGGTGGTGAC
CCTGTGCAGGAGTGATAATAACCTGTGCAG|TCCCAGAATCCGCATATATACAGCCATTTC
TTTTTGATAATAACCTGTGCAGGAGTCAAC|ATACAGCAGTGACCGAAGCGGTTTCTGCCT
TGAGCCGACCCTTGGTGGTGACCTGGCCGT|AATCCCGACGATAATAACCTGTGCAGGAGT
CGGATAATAACCTGTGCAGGAGTGATAATA|AGCCGACCCTTGGTGGTGACCTGGCCGTAA
AAACCGGTGATGGTCCCGAATCATAGTAAC|GCAGGAGTCAACCCCAATAATAACCTGTGC
TTGGGTTTCTGTACATCGAGATAATAACCT|GGGCACCCGATGATAACGGCGCAATGTCGC
GTCCGTTTGAGATAATTTCGGGCGGAATTC|CGAAACCGGTGATGGTCCCGAATCATAGTA
ACAGAAGCTCGTTACCCCATGCCGAATGCC|GTCGCATTTTGATAATAACCTGTGCAGGAG
CGATAATAACCTGTGCAGGAGTCAACCCCA|AATAAAAAATCTAGGCAACTAGATACCTAG
TTGTTCAGAAACGTGTCACCTCGTAGCTAC|CCGTGTTCTTCTATGGTACTTAGTACTGGC
CCGAAACCGGTGATGGTCCCGAATCATAGT|TGTGCAGGAGTCAACCCCAATAATAACCTG
GATAATAACCTGTGCAGGAGTCAACCCCAA|GCCGTAAGTATCCGATAATAACCTGTGCAG
AACCTGTGCAGGAGTCAACCCCAATTTCGA|AGCCTACATCGGAAAATCGTTGGTCCTGAA
GTGCAGGAGTGATAATAACCTGTGCAGGAG|TGGTGACCTGGCCGTAAGTATCCGATAATA
TACCCCATGCCGAATGCCTATTGGCGCCTG|TAATAACCTGTGCAGGAGTCAACCCCAACG
AAGCCAACCACGCGGATAATAACCTGTGCA|CACACGGTGATGAGCCGACCCTTGGTGGTG
GCGCGATAATAACCTGTGCAGGAGTCAACC|CGCTACAGTGAGCCTACATCGGAAAATCGT
CGATAATAACCTGTGCAGGAGTCAACCCCA|TACAGTGAGCCTACATCGGAAAATCGTTGG
CGATAATAACCTGTGCAGGAGTCAACCCCA|AGTCAACCCCAACAACCCCAATACGACGGC
GGATTGGGTTTCTGTACATCGAGATAATAA|GCGGGGCACCCGATGATAACGGCGCAATGT
AAACGCATCTTGTGTCCGTTTGAGATAATT|GCTTTTCTGTGCCCGAAACCGGTGATGGTC
ACTAAGTAGTAAACAATCCCGACGATAATA|CTGCGCGATAATAACCTGTGCAGGAGTCAA
CACCCTGAATTGTTCAGAAACGTGTCACCT|GGCTTTCCACCGTGTTCTTCTATGGTACTT
TGGTGACCTGGCCGTAAGTATCCGATAATA|AACCTGTGCAGGAGTCAACCCCAATAAAAA
TGTTATTACAGCGGTACGATACAGAAGCTC|GAAGAAAGTCGAACGAAGCTGTCGCATTTT
GCCGAATGCCTATTGGCGCCTGGTCCCCAA|TGTGCAGGAGTCAACCCCAACGGATTGGGT
AGTCAACCCCAAGACTTCACGCGCGATAAT|TAGATACCTAGTGTCTGCGACGCTACAGTG
TTCTGTACATCGAGATAATAACCTGTGCAG|CCGATGATAACGGCGCAATGTCGCCTCTTG
GCAACTAGATACCTAGTGTCTGCGACGCTA|AGCTGTCTTACCGGACTAGTTTCGATGCCA
AACGGCGCAATGTCGCCTCTTGTACCTCCA|AAAGAGATAATAACCGATAATAACCTGTGC
GCTCGTTACCCCATGCCGAATGCCTATTGG|TTTTGATAATAACCTGTGCAGGAGTCAACC
AATAACCTGTGCAGGAGTCAACCCCAATAA|TCAACCCCAAGAGAGTGGGGTTTGCGTAAC
CGCGCGATAATAACCTGTGCAGGAGTCAAC|ACGCTACAGTGAGCCTACATCGGAAAATCG
ACCTGTGCAGGAGTCAACCCCAACCTATTC|CCGAAGCGGTTTCTGCCTCAACGAGCGGAC
GGGTTTGCGTAACCCCACGGCCAGCTGTCT|CCTCGTAGCTACCGAGTAGCTCTATCTTAG
GGTCCCCAACTCGCTATCCCAGAATCCGCA|GGATTGGGTTTCTGTACATCGAGATAATAA
GAACGAAGCTGTCGCATTTTGATAATAACC|TTCGGGCGGAATTCAAATGCGCAGAAGGGA
TCCAACGGCTTTTCTGTGCCCGAAACCGGT|GTGCAGGAGTCAACCCCAATGTGCAGGAGT
ATAATTTCGGGCGGAATTCAAATGCGCAGA|ATGGTCCCGAATCATAGTAACTGCACGAAA
TTGGGGAGGTGTCCGGCAACTCCGCACGAG|AACCCCAACCTATTCACGTCGTAATACCGC
GGGTTTCTGTACATCGAGATAATAACCTGT|GCACCCGATGATAACGGCGCAATGTCGCCT
TGTCTGCGACGCTACAGTGAGCCTACATCG|TAGTTTCGATGCCATCACATTTGGGGAGGT
CATGCCGAATGCCTATTGGCGCCTGGTCCC|ACCTGTGCAGGAGTCAACCCCAACGGATTG
CCTGTGCAGGAGTCAACCCCAACGGATTGG|GAACGGTTTATGAGACGATGCTTGCGGGGC
CTTTTCTGTGCCCGAAACCGGTGATGGTCC|GTCAACCCCAATGTGCAGGAGTCAACCCCA
GTAACTGCACGAAAACCGTGATAATAACCT|TGTGCAGGAGTCAACCCCAAGCCAACCACG
AAGCTCGTTACCCCATGCCGAATGCCTATT|CATTTTGATAATAACCTGTGCAGGAGTCAA
AGGAGTCAACCCCAAAGTGAATAAAAGAGA|TAATAACCTGTGCAGGAGTGATAATAACCT
CAGGAGTCAACCCCAAGAGAGTGGGGTTTG|CTGAATTGTTCAGAAACGTGTCACCTCGTA
TGATGAGCCGACCCTTGGTGGTGACCTGGC|AACAATCCCGACGATAATAACCTGTGCAGG
TTGTGTCCGTTTGAGATAATTTCGGGCGGA|TGCCCGAAACCGGTGATGGTCCCGAATCAT
CGCGATAATAACCTGTGCAGGAGTCAACCC|GTATCAGACTTGGCACCCTGAATTGTTCAG
CATTTGGGGAGGTGTCCGGCAACTCCGCAC|GTCAACCCCAACCTATTCACGTCGTAATAC
GATACCTAGTGTCTGCGACGCTACAGTGAG|TTACCGGACTAGTTTCGATGCCATCACATT
AACCTGTGCAGGAGTGATAATAACCTGTGC|TATCCCAGAATCCGCATATATACAGCCATT
GATAATAACCTGTGCAGGAGTCAACCCCAA|ATATATACAGCCATTTCGGAAGACAGGCAT
CAACGGCTTTTCTGTGCCCGAAACCGGTGA|GCAGGAGTCAACCCCAATGTGCAGGAGTCA
ATAACCTGTGCAGGAGTCAACCCCAATTTC|TGAGCCTACATCGGAAAATCGTTGGTCCTG
TGGCGCCTGGTCCCCAACTCGCTATCCCAG|ACCCCAACGGATTGGGTTTCTGTACATCGA
CAACTGTTATTACAGCGGTACGATACAGAA|CGGAGAAGAAAGTCGAACGAAGCTGTCGCA
TAAAAAATCTAGGCAACTAGATACCTAGTG|AACCCCACGGCCAGCTGTCTTACCGGACTA
CCCCAATGTGCAGGAGTCAACCCCAATAAT|ACGGCTATGCGGAGGTACTAAAGGTATGCC
CAACCCCAATTTCGAACTAAGTAGTAAACA|ATCGTTGGTCCTGAACTGCGCGATAATAAC
CTGTGCAGGAGTCAACCCCAACGGATTGGG|AACGGTTTATGAGACGATGCTTGCGGGGCA
AGCTGTCTTACCGGACTAGTTTCGATGCCA|TATCTTAGTTTTTTGATAATAACCTGTGCA
CAGGAGTCAACCCCAACAACCCCAATACGA|ATAATAACCTGTGCAGGAGTCAACCCCAAG
AACCTGTGCAGGAGTCAACCCCAAGACTTC|AATCTAGGCAACTAGATACCTAGTGTCTGC
CATCGGAAAATCGTTGGTCCTGAACTGCGC|GAGGTGTCCGGCAACTCCGCACGAGCCGTA
ACGGCTATGCGGAGGTACTAAAGGTATGCC|GACTTCACGCGCGATAATAACCTGTGCAGG
GATGATAACGGCGCAATGTCGCCTCTTGTA|TGAATAAAAGAGATAATAACCGATAATAAC
GAATTCAAATGCGCAGAAGGGAACGGTTTA|ATAGTAACTGCACGAAAACCGTGATAATAA
CATCACATTTGGGGAGGTGTCCGGCAACTC|CAGGAGTCAACCCCAACCTATTCACGTCGT
GGGCGGAATTCAAATGCGCAGAAGGGAACG|GAATCATAGTAACTGCACGAAAACCGTGAT
CCATTTCGGAAGACAGGCATTTACGCCGGA|GAGTCAACCCCAAACGCATCTTGTGTCCGT
CAACAACCCCAATACGACGGCTATGCGGAG|CAGGAGTCAACCCCAAGACTTCACGCGCGA
CACGTCGTAATACCGCTACAACTTGCTGAG|CACAGAAAAAGATCTGACGTTGGCGCTTAC
AACCTGTGCAGGAGTCAACCCCAATGTGCA|CCCAACAACCCCAATACGACGGCTATGCGG
TAATAACCTGTGCAGGAGTCAACCCCAATG|CAACCCCAACAACCCCAATACGACGGCTAT
ACTGTTATTACAGCGGTACGATACAGAAGC|GAGAAGAAAGTCGAACGAAGCTGTCGCATT
TAATAACCTGTGCAGGAGTCAACCCCAATA|GTCAACCCCAAGAGAGTGGGGTTTGCGTAA
CGAGATAATAACCTGTGCAGGAGTCAACCC|CGGCGCAATGTCGCCTCTTGTACCTCCAAC
GTGCCCGAAACCGGTGATGGTCCCGAATCA|CCAATGTGCAGGAGTCAACCCCAATAATAA
TAAGTAGTAAACAATCCCGACGATAATAAC|GCGCGATAATAACCTGTGCAGGAGTCAACC
TTTGAGATAATTTCGGGCGGAATTCAAATG|CCGGTGATGGTCCCGAATCATAGTAACTGC
CTAGATACCTAGTGTCTGCGACGCTACAGT|GTCTTACCGGACTAGTTTCGATGCCATCAC
AGATAATAACCGATAATAACCTGTGCAGGA|CCTGTGCAGGAGTCAACCCCAACAACCCCA
GGTACGATACAGAAGCTCGTTACCCCATGC|ACGAAGCTGTCGCATTTTGATAATAACCTG
AATCTAGGCAACTAGATACCTAGTGTCTGC|CACGGCCAGCTGTCTTACCGGACTAGTTTC
GATGAAGTGCGCGGCGGCGATAATAACCTG|ATTGGCGCCTGGTCCCCAACTCGCTATCCC
CGGTGATGAGCCGACCCTTGGTGGTGACCT|GTAAACAATCCCGACGATAATAACCTGTGC
AATCATAGTAACTGCACGAAAACCGTGATA|AATAACCTGTGCAGGAGTCAACCCCAAGCC
CCAATACGACGGCTATGCGGAGGTACTAAA|AACCCCAAGACTTCACGCGCGATAATAACC
GCCGGAGAAGAAAGTCGAACGAAGCTGTCG|GTCCGTTTGAGATAATTTCGGGCGGAATTC
AGTCAACCCCAACCTATTCACGTCGTAATA|TCTGCCTCAACGAGCGGACACAGAAAAAGA
TGTCCGTTTGAGATAATTTCGGGCGGAATT|CCGAAACCGGTGATGGTCCCGAATCATAGT
TAATAACCTGTGCAGGAGTCAACCCCAAAC|CAATGTCGCCTCTTGTACCTCCAACGGCTT
GAGATAATAACCTGTGCAGGAGTCAACCCC|GGCGCAATGTCGCCTCTTGTACCTCCAACG
CTCTAACTAATTTATACTGGTCACACGGTG|GTCAACCCCAATTTCGAACTAAGTAGTAAA
CCTGTGCAGGAGTCAACCCCAAAGTGAATA|ACGCGGATAATAACCTGTGCAGGAGTGATA
CGTAACCCCACGGCCAGCTGTCTTACCGGA|GCTACCGAGTAGCTCTATCTTAGTTTTTTG
GAGTAGCTCTATCTTAGTTTTTTGATAATA|AGACGCATGTACCTAATCATACAGCAGTGA
AGTCAACCCCAACAACCCCAACTGTTATTA|GAAGACAGGCATTTACGCCGGAGAAGAAAG
CTCTATCTTAGTTTTTTGATAATAACCTGT|ATGTACCTAATCATACAGCAGTGACCGAAG
GTGCAGGAGTCAACCCCAAACGCATCTTGT|CTCTTGTACCTCCAACGGCTTTTCTGTGCC
ACAGTGAGCCTACATCGGAAAATCGTTGGT|ATCACATTTGGGGAGGTGTCCGGCAACTCC
ACCACGCGGATAATAACCTGTGCAGGAGTG|GTGATGAGCCGACCCTTGGTGGTGACCTGG
GTGTCTGCGACGCTACAGTGAGCCTACATC|CTAGTTTCGATGCCATCACATTTGGGGAGG
CCCCAAGACTTCACGCGCGATAATAACCTG|CCTAGTGTCTGCGACGCTACAGTGAGCCTA
TTTCGATGCCATCACATTTGGGGAGGTGTC|TAACCTGTGCAGGAGTCAACCCCAACCTAT
AGTCAACCCCAAAGTGAATAAAAGAGATAA|TAACCTGTGCAGGAGTGATAATAACCTGTG
TATCAGACTTGGCACCCTGAATTGTTCAGA|AACTTGCTGAGTGGCTTTCCACCGTGTTCT
AACCCCAACAACCCCAATACGACGGCTATG|CTGTGCAGGAGTCAACCCCAAGACTTCACG
GGCGCAATGTCGCCTCTTGTACCTCCAACG|GAGATAATAACCGATAATAACCTGTGCAGG
CTGAATTGTTCAGAAACGTGTCACCTCGTA|TTCCACCGTGTTCTTCTATGGTACTTAGTA
AGATACCTAGTGTCTGCGACGCTACAGTGA|CTTACCGGACTAGTTTCGATGCCATCACAT
GACTTGGCACCCTGAATTGTTCAGAAACGT|GCTGAGTGGCTTTCCACCGTGTTCTTCTAT
CCTGTGCAGGAGTCAACCCCAACCTATTCA|CGAAGCGGTTTCTGCCTCAACGAGCGGACA
ACGCTACAGTGAGCCTACATCGGAAAATCG|ATGCCATCACATTTGGGGAGGTGTCCGGCA
TAATAACCGATAATAACCTGTGCAGGAGTC|GTGCAGGAGTCAACCCCAACAACCCCAATA
ATAATAACCTGTGCAGGAGTGATAATAACC|CGACCCTTGGTGGTGACCTGGCCGTAAGTA
GTGACCTGGCCGTAAGTATCCGATAATAAC|CCTGTGCAGGAGTCAACCCCAATAAAAAAT
TAATAACCTGTGCAGGAGTCAACCCCAAGA|AGACTTGGCACCCTGAATTGTTCAGAAACG
TTACAGCGGTACGATACAGAAGCTCGTTAC|AAGTCGAACGAAGCTGTCGCATTTTGATAA
GATAATAACCGATAATAACCTGTGCAGGAG|CTGTGCAGGAGTCAACCCCAACAACCCCAA
AGTCAACCCCAATAAAAAATCTAGGCAACT|TGGGGTTTGCGTAACCCCACGGCCAGCTGT
CCAAACGCATCTTGTGTCCGTTTGAGATAA|CGGCTTTTCTGTGCCCGAAACCGGTGATGG
TACGCCGGAGAAGAAAGTCGAACGAAGCTG|TGTGTCCGTTTGAGATAATTTCGGGCGGAA
GAGTCAACCCCAAGAGAGTGGGGTTTGCGT|AATTGTTCAGAAACGTGTCACCTCGTAGCT
CAACTCGCTATCCCAGAATCCGCATATATA|GGTTTCTGTACATCGAGATAATAACCTGTG
TGCGTAACCCCACGGCCAGCTGTCTTACCG|TAGCTACCGAGTAGCTCTATCTTAGTTTTT
TCAGAAACGTGTCACCTCGTAGCTACCGAG|GTTCTTCTATGGTACTTAGTACTGGCAAGA
AGCTCGTTACCCCATGCCGAATGCCTATTG|ATTTTGATAATAACCTGTGCAGGAGTCAAC
GAAAATCGTTGGTCCTGAACTGCGCGATAA|GTCCGGCAACTCCGCACGAGCCGTATCAGA
GTGTCACCTCGTAGCTACCGAGTAGCTCTA|ATGGTACTTAGTACTGGCAAGACGCATGTA
GCAGGAGTGATAATAACCTGTGCAGGAGTC|GAATCCGCATATATACAGCCATTTCGGAAG
AATAACCTGTGCAGGAGTCAACCCCAACAA|GTAAGTATCCGATAATAACCTGTGCAGGAG
GGAGGTGTCCGGCAACTCCGCACGAGCCGT|CCAACCTATTCACGTCGTAATACCGCTACA
TCGGGCGGAATTCAAATGCGCAGAAGGGAA|CCGAATCATAGTAACTGCACGAAAACCGTG
CTGTACATCGAGATAATAACCTGTGCAGGA|GATGATAACGGCGCAATGTCGCCTCTTGTA
CCGCATATATACAGCCATTTCGGAAGACAG|AATAACCTGTGCAGGAGTCAACCCCAAACG
TTCGGGCGGAATTCAAATGCGCAGAAGGGA|CCCGAATCATAGTAACTGCACGAAAACCGT
TTACCCCATGCCGAATGCCTATTGGCGCCT|ATAATAACCTGTGCAGGAGTCAACCCCAAC
GTTTATGAGACGATGCTTGCGGGGCACCCG|AATAACCTGTGCAGGAGTCAACCCCAAAGT
AAACGTGTCACCTCGTAGCTACCGAGTAGC|TTCTATGGTACTTAGTACTGGCAAGACGCA
ACGCGCGATAATAACCTGTGCAGGAGTCAA|GACGCTACAGTGAGCCTACATCGGAAAATC
AACAACCCCAATACGACGGCTATGCGGAGG|AGGAGTCAACCCCAAGACTTCACGCGCGAT
CGGCGATAATAACCTGTGCAGGAGTGATAA|CCCAACTCGCTATCCCAGAATCCGCATATA
AATTTATACTGGTCACACGGTGATGAGCCG|CAATTTCGAACTAAGTAGTAAACAATCCCG
TAACCTGTGCAGGAGTCAACCCCAACCTAT|GACCGAAGCGGTTTCTGCCTCAACGAGCGG
CAGGAGTCAACCCCAATAAAAAATCTAGGC|AGAGTGGGGTTTGCGTAACCCCACGGCCAG
GCACGAGCCGTATCAGACTTGGCACCCTGA|ATACCGCTACAACTTGCTGAGTGGCTTTCC
TCTAGGCAACTAGATACCTAGTGTCTGCGA|CGGCCAGCTGTCTTACCGGACTAGTTTCGA
CCCAATAAAAAATCTAGGCAACTAGATACC|TGCGTAACCCCACGGCCAGCTGTCTTACCG
ATGGTCCCGAATCATAGTAACTGCACGAAA|AACCCCAATAATAACCTGTGCAGGAGTCAA
GCAGGAGTGATAATAACCTGTGCAGGAGTC|GTGACCTGGCCGTAAGTATCCGATAATAAC
AGGTACTAAAGGTATGCCGCTCTAACTAAT|GATAATAACCTGTGCAGGAGTCAACCCCAA
GCGCAATGTCGCCTCTTGTACCTCCAACGG|AGATAATAACCGATAATAACCTGTGCAGGA
TGTGTCCGTTTGAGATAATTTCGGGCGGAA|GCCCGAAACCGGTGATGGTCCCGAATCATA
TAACCGATAATAACCTGTGCAGGAGTCAAC|CAGGAGTCAACCCCAACAACCCCAATACGA
GCGGTACGATACAGAAGCTCGTTACCCCAT|GAACGAAGCTGTCGCATTTTGATAATAACC
GGCACCCTGAATTGTTCAGAAACGTGTCAC|GTGGCTTTCCACCGTGTTCTTCTATGGTAC
GCAGGAGTCAACCCCAAGACTTCACGCGCG|GCAACTAGATACCTAGTGTCTGCGACGCTA
ACATCGGAAAATCGTTGGTCCTGAACTGCG|GGAGGTGTCCGGCAACTCCGCACGAGCCGT
GTAACCCCACGGCCAGCTGTCTTACCGGAC|CTACCGAGTAGCTCTATCTTAGTTTTTTGA
CGATGCCATCACATTTGGGGAGGTGTCCGG|CCTGTGCAGGAGTCAACCCCAACCTATTCA
AGAGTGGGGTTTGCGTAACCCCACGGCCAG|GTGTCACCTCGTAGCTACCGAGTAGCTCTA
AGTCAACCCCAACGGATTGGGTTTCTGTAC|TGAGACGATGCTTGCGGGGCACCCGATGAT
AATGCGCAGAAGGGAACGGTTTATGAGACG|CTGCACGAAAACCGTGATAATAACCTGTGC
TGCGCAGAAGGGAACGGTTTATGAGACGAT|GCACGAAAACCGTGATAATAACCTGTGCAG
GTGATAATAACCTGTGCAGGAGTCAACCCC|GCATATATACAGCCATTTCGGAAGACAGGC
AACTAGATACCTAGTGTCTGCGACGCTACA|CTGTCTTACCGGACTAGTTTCGATGCCATC
AGGGAACGGTTTATGAGACGATGCTTGCGG|ACCGTGATAATAACCTGTGCAGGAGTCAAC
TCATAGTAACTGCACGAAAACCGTGATAAT|TAACCTGTGCAGGAGTCAACCCCAAGCCAA
TCCGATAATAACCTGTGCAGGAGTCAACCC|CCAATAAAAAATCTAGGCAACTAGATACCT
GCAGGAGTCAACCCCAACAACCCCAATACG|GATAATAACCTGTGCAGGAGTCAACCCCAA
TAATAACCTGTGCAGGAGTCAACCCCAACG|AGAAGGGAACGGTTTATGAGACGATGCTTG
ACCTGTGCAGGAGTCAACCCCAATGTGCAG|CCAACAACCCCAATACGACGGCTATGCGGA
GAGTCAACCCCAAGCCAACCACGCGGATAA|TTTATACTGGTCACACGGTGATGAGCCGAC
GAAGACAGGCATTTACGCCGGAGAAGAAAG|CCCAAACGCATCTTGTGTCCGTTTGAGATA
CAATAAAAAATCTAGGCAACTAGATACCTA|CGTAACCCCACGGCCAGCTGTCTTACCGGA
TAACTAATTTATACTGGTCACACGGTGATG|AACCCCAATTTCGAACTAAGTAGTAAACAA
AACTGCACGAAAACCGTGATAATAACCTGT|TGCAGGAGTCAACCCCAAGCCAACCACGCG
CAGGAGTCAACCCCAACAACCCCAACTGTT|TTCGGAAGACAGGCATTTACGCCGGAGAAG
CAACTAGATACCTAGTGTCTGCGACGCTAC|GCTGTCTTACCGGACTAGTTTCGATGCCAT
ATCCCGACGATAATAACCTGTGCAGGAGTC|CTGTGCAGGAGTCAACCCCAAGAGAGTGGG
AGTTTTTTGATAATAACCTGTGCAGGAGTC|ATCATACAGCAGTGACCGAAGCGGTTTCTG
GACGATAATAACCTGTGCAGGAGTCAACCC|CAGGAGTCAACCCCAAGAGAGTGGGGTTTG
GACTAGTTTCGATGCCATCACATTTGGGGA|TGATAATAACCTGTGCAGGAGTCAACCCCA
CAACCCCAACAACCCCAACTGTTATTACAG|GACAGGCATTTACGCCGGAGAAGAAAGTCG
AGTGCGCGGCGGCGATAATAACCTGTGCAG|CGCCTGGTCCCCAACTCGCTATCCCAGAAT
CAATCCCGACGATAATAACCTGTGCAGGAG|ACCTGTGCAGGAGTCAACCCCAAGAGAGTG
CCCAACAACCCCAACTGTTATTACAGCGGT|GGCATTTACGCCGGAGAAGAAAGTCGAACG
GGCCGTAAGTATCCGATAATAACCTGTGCA|AGGAGTCAACCCCAATAAAAAATCTAGGCA
TGCCTATTGGCGCCTGGTCCCCAACTCGCT|GGAGTCAACCCCAACGGATTGGGTTTCTGT
ACCCTTGGTGGTGACCTGGCCGTAAGTATC|ACGATAATAACCTGTGCAGGAGTCAACCCC
GCCGTATCAGACTTGGCACCCTGAATTGTT|CTACAACTTGCTGAGTGGCTTTCCACCGTG
CCATCACATTTGGGGAGGTGTCCGGCAACT|GCAGGAGTCAACCCCAACCTATTCACGTCG
TCTAACTAATTTATACTGGTCACACGGTGA|TCAACCCCAATTTCGAACTAAGTAGTAAAC
CTGTGCAGGAGTCAACCCCAACAACCCCAA|ATCCGATAATAACCTGTGCAGGAGTCAACC
GCGCCTGGTCCCCAACTCGCTATCCCAGAA|CCCAACGGATTGGGTTTCTGTACATCGAGA
AGTCAACCCCAAACGCATCTTGTGTCCGTT|ACCTCCAACGGCTTTTCTGTGCCCGAAACC
GTACATCGAGATAATAACCTGTGCAGGAGT|TGATAACGGCGCAATGTCGCCTCTTGTACC
ATTCACGTCGTAATACCGCTACAACTTGCT|GGACACAGAAAAAGATCTGACGTTGGCGCT
ACAGCGGTACGATACAGAAGCTCGTTACCC|GTCGAACGAAGCTGTCGCATTTTGATAATA
CGCTCTAACTAATTTATACTGGTCACACGG|GAGTCAACCCCAATTTCGAACTAAGTAGTA
GTACGATACAGAAGCTCGTTACCCCATGCC|CGAAGCTGTCGCATTTTGATAATAACCTGT
TGCGACGCTACAGTGAGCCTACATCGGAAA|TTCGATGCCATCACATTTGGGGAGGTGTCC
AGTAAACAATCCCGACGATAATAACCTGTG|ATAATAACCTGTGCAGGAGTCAACCCCAAG
CAGGAGTCAACCCCAAAGTGAATAAAAGAG|ATAATAACCTGTGCAGGAGTGATAATAACC
CTGGTCCCCAACTCGCTATCCCAGAATCCG|ACGGATTGGGTTTCTGTACATCGAGATAAT
ATGCCGAATGCCTATTGGCGCCTGGTCCCC|CCTGTGCAGGAGTCAACCCCAACGGATTGG
GATAATAACCTGTGCAGGAGTCAACCCCAA|TCAGACTTGGCACCCTGAATTGTTCAGAAA
TACCTCCAACGGCTTTTCTGTGCCCGAAAC|ACCTGTGCAGGAGTCAACCCCAATGTGCAG
CCTCGTAGCTACCGAGTAGCTCTATCTTAG|CTTAGTACTGGCAAGACGCATGTACCTAAT
CACGGCCAGCTGTCTTACCGGACTAGTTTC|GTAGCTCTATCTTAGTTTTTTGATAATAAC
TGTTCAGAAACGTGTCACCTCGTAGCTACC|CGTGTTCTTCTATGGTACTTAGTACTGGCA
ACCCCAACCTATTCACGTCGTAATACCGCT|CTCAACGAGCGGACACAGAAAAAGATCTGA
GCGATAATAACCTGTGCAGGAGTCAACCCC|CTACAGTGAGCCTACATCGGAAAATCGTTG
ATAAAAAATCTAGGCAACTAGATACCTAGT|TAACCCCACGGCCAGCTGTCTTACCGGACT
GCACGAAAACCGTGATAATAACCTGTGCAG|GGAGTCAACCCCAAGCCAACCACGCGGATA
CCCCAATACGACGGCTATGCGGAGGTACTA|TCAACCCCAAGACTTCACGCGCGATAATAA
GGTATGCCGCTCTAACTAATTTATACTGGT|TGTGCAGGAGTCAACCCCAATTTCGAACTA
CAAGACTTCACGCGCGATAATAACCTGTGC|AGTGTCTGCGACGCTACAGTGAGCCTACAT
TCAACCCCAAACGCATCTTGTGTCCGTTTG|CTCCAACGGCTTTTCTGTGCCCGAAACCGG
ATAACCTGTGCAGGAGTGATAATAACCTGT|GCTATCCCAGAATCCGCATATATACAGCCA
CTAATTTATACTGGTCACACGGTGATGAGC|CCCAATTTCGAACTAAGTAGTAAACAATCC
GATAATAACCTGTGCAGGAGTCAACCCCAA|GTCAACCCCAACAACCCCAATACGACGGCT
ACCTCCAACGGCTTTTCTGTGCCCGAAACC|CCTGTGCAGGAGTCAACCCCAATGTGCAGG
CCCAAACGCATCTTGTGTCCGTTTGAGATA|ACGGCTTTTCTGTGCCCGAAACCGGTGATG
TCCTGAACTGCGCGATAATAACCTGTGCAG|CGCACGAGCCGTATCAGACTTGGCACCCTG
TCGAACGAAGCTGTCGCATTTTGATAATAA|ATTTCGGGCGGAATTCAAATGCGCAGAAGG
CCAGCTGTCTTACCGGACTAGTTTCGATGC|TCTATCTTAGTTTTTTGATAATAACCTGTG
CCGCTCTAACTAATTTATACTGGTCACACG|GGAGTCAACCCCAATTTCGAACTAAGTAGT
GTCGAACGAAGCTGTCGCATTTTGATAATA|AATTTCGGGCGGAATTCAAATGCGCAGAAG
GCAGGAGTCAACCCCAAACGCATCTTGTGT|CTTGTACCTCCAACGGCTTTTCTGTGCCCG
CTTCACGCGCGATAATAACCTGTGCAGGAG|CTGCGACGCTACAGTGAGCCTACATCGGAA
GTAGCTCTATCTTAGTTTTTTGATAATAAC|ACGCATGTACCTAATCATACAGCAGTGACC
AATAACCTGTGCAGGAGTGATAATAACCTG|ACCCTTGGTGGTGACCTGGCCGTAAGTATC
ATAACGGCGCAATGTCGCCTCTTGTACCTC|TAAAAGAGATAATAACCGATAATAACCTGT
TTCGATGCCATCACATTTGGGGAGGTGTCC|AACCTGTGCAGGAGTCAACCCCAACCTATT
CCCGAAACCGGTGATGGTCCCGAATCATAG|ATGTGCAGGAGTCAACCCCAATAATAACCT
ACCTGTGCAGGAGTGATAATAACCTGTGCA|ATCCCAGAATCCGCATATATACAGCCATTT
TCAGACTTGGCACCCTGAATTGTTCAGAAA|CTTGCTGAGTGGCTTTCCACCGTGTTCTTC
AAGAAAGTCGAACGAAGCTGTCGCATTTTG|TGAGATAATTTCGGGCGGAATTCAAATGCG
GGGCACCCGATGATAACGGCGCAATGTCGC|CCCCAAAGTGAATAAAAGAGATAATAACCG
ACTTGGCACCCTGAATTGTTCAGAAACGTG|CTGAGTGGCTTTCCACCGTGTTCTTCTATG
TTGATAATAACCTGTGCAGGAGTCAACCCC|CAGCAGTGACCGAAGCGGTTTCTGCCTCAA
GACCCTTGGTGGTGACCTGGCCGTAAGTAT|GACGATAATAACCTGTGCAGGAGTCAACCC
CCAATTTCGAACTAAGTAGTAAACAATCCC|TGGTCCTGAACTGCGCGATAATAACCTGTG
ACAGGCATTTACGCCGGAGAAGAAAGTCGA|AACGCATCTTGTGTCCGTTTGAGATAATTT
TAGTAAACAATCCCGACGATAATAACCTGT|GATAATAACCTGTGCAGGAGTCAACCCCAA
ACCCCACGGCCAGCTGTCTTACCGGACTAG|CCGAGTAGCTCTATCTTAGTTTTTTGATAA
CAGGAGTCAACCCCAAACGCATCTTGTGTC|TTGTACCTCCAACGGCTTTTCTGTGCCCGA
ATAACCTGTGCAGGAGTCAACCCCAAAGTG|AACCACGCGGATAATAACCTGTGCAGGAGT
TAACCTGTGCAGGAGTCAACCCCAACAACC|AAGTATCCGATAATAACCTGTGCAGGAGTC
AGTCAACCCCAATAATAACCTGTGCAGGAG|GTACTAAAGGTATGCCGCTCTAACTAATTT
TAACCTGTGCAGGAGTCAACCCCAATGTGC|CCCCAACAACCCCAATACGACGGCTATGCG
TTTATGAGACGATGCTTGCGGGGCACCCGA|ATAACCTGTGCAGGAGTCAACCCCAAAGTG
GTACCTCCAACGGCTTTTCTGTGCCCGAAA|AACCTGTGCAGGAGTCAACCCCAATGTGCA
CGAAAACCGTGATAATAACCTGTGCAGGAG|GTCAACCCCAAGCCAACCACGCGGATAATA
AAACAATCCCGACGATAATAACCTGTGCAG|ATAACCTGTGCAGGAGTCAACCCCAAGAGA
TTGGCACCCTGAATTGTTCAGAAACGTGTC|GAGTGGCTTTCCACCGTGTTCTTCTATGGT
CAACCCCAAGACTTCACGCGCGATAATAAC|ATACCTAGTGTCTGCGACGCTACAGTGAGC
CAGGCATTTACGCCGGAGAAGAAAGTCGAA|ACGCATCTTGTGTCCGTTTGAGATAATTTC
GGTCCCGAATCATAGTAACTGCACGAAAAC|CCCCAATAATAACCTGTGCAGGAGTCAACC
GTGTCCGTTTGAGATAATTTCGGGCGGAAT|CCCGAAACCGGTGATGGTCCCGAATCATAG
GTTCGATGAAGTGCGCGGCGGCGATAATAA|GCCTATTGGCGCCTGGTCCCCAACTCGCTA
TGAGCCTACATCGGAAAATCGTTGGTCCTG|CATTTGGGGAGGTGTCCGGCAACTCCGCAC
ACTTCACGCGCGATAATAACCTGTGCAGGA|TCTGCGACGCTACAGTGAGCCTACATCGGA
GTCGTTCGATGAAGTGCGCGGCGGCGATAA|AATGCCTATTGGCGCCTGGTCCCCAACTCG
AACCCCAATACGACGGCTATGCGGAGGTAC|AGTCAACCCCAAGACTTCACGCGCGATAAT
ACCCGATGATAACGGCGCAATGTCGCCTCT|AAAGTGAATAAAAGAGATAATAACCGATAA
GAATTGTTCAGAAACGTGTCACCTCGTAGC|CCACCGTGTTCTTCTATGGTACTTAGTACT
CAACCTATTCACGTCGTAATACCGCTACAA|ACGAGCGGACACAGAAAAAGATCTGACGTT
TTATTACAGCGGTACGATACAGAAGCTCGT|AGAAAGTCGAACGAAGCTGTCGCATTTTGA
CCTGGTCCCCAACTCGCTATCCCAGAATCC|AACGGATTGGGTTTCTGTACATCGAGATAA
TGATAATAACCTGTGCAGGAGTCAACCCCA|AGCAGTGACCGAAGCGGTTTCTGCCTCAAC
